"lang"
{
"Language"	"german"
"Tokens"
{
// asw
"asw_SynTekMegacorp"	"SynTek Megacorporation, Inc."
"asw_SynTekPDA"	"SynTek Persönlicher Digitaler Assistant"
"asw_SynTekAccount"	"Benutzer: %s1"
"asw_SynTekSlogan1"	"\"Überschreitet die Möglichkeiten der Menschheit.\""
"asw_SynTekSlogan2"	"\"Pioniere des Weltraums und der Wissenschaft.\""
"asw_SynTekSlogan3"	"\"Wir greifen nach den Sternen.\""
"asw_SynTekSlogan4"	"\"Wir übernehmen Verantwortung.\""
"asw_SynTekSlogan5"	"\"Wir verbessern den Entwurf der Natur.\""
"asw_SynTekScrollLine0"	"Boot-ROM korrekt signiert."
"asw_SynTekScrollLine1"	"Authentifizierung des Betriebssystems erfolgreich."
"asw_SynTekScrollLine2"	"SynNET-Verbindung..."
"asw_SynTekScrollLine3"	"."
"asw_SynTekScrollLine4"	"."
"asw_SynTekScrollLine5"	"hergestellt!"
"asw_SynTekScrollLine6"	"."
"asw_SynTekScrollLine7"	"Überprüfe auf Ungültigkeiten im Binärcode..."
"asw_SynTekScrollLine8"	"Überwachungsprozess des SynTek HQs gestartet."
"asw_SynTekScrollLine9"	"."
"asw_SynTekScrollLine10"	"Starte Sicherheitsmodul für Benutzer..."
"asw_SynTekScrollLine11"	"."
"asw_SynTekScrollLine12"	"IAF-Transponder erkannt."
"asw_SynTekScrollLine13"	"Code IAFN6392-SYN Klasse 5 Anlagen-Notfallsignal erkannt."
"asw_SynTekScrollLine14"	"Code für manuellen Eingriff akzeptiert."
"asw_SynTekScrollLine15"	"."
"asw_SynTekScrollLine16"	"SynTek Megacorporation Netzwerk-Terminal gewährt Gast-Benutzerrechte für"
"asw_SynTekScrollLine17"	"Private David 'Crash' Murphy."
"asw_SynTekScrollLine18"	"Mit Befugnis durch das Interstellare Konzernkommunikationsgesetz #8726/K23, Abschnitt 5"
"asw_SynTekScrollLine19"	"für die Verwendung eines kritischen Systems in einer Klasse-5-Notsituation."
"asw_SynTekScrollLine20"	"."
"asw_SynTekScrollLine21"	"Alle Tätigkeiten werden aufgezeichnet und jeder nicht notwendige Datenzugriff wird zu"
"asw_SynTekScrollLine22"	"rechtlichen Schritten und dem Entzug der SynTek-Kundenprivilegien führen."
"asw_SynTekScrollLine23"	"."
"asw_SynTekScrollLine24"	"Spezifiziere Menü-Optionen der Gast-Benutzeroberfläche..."
"asw_SynTekScrollLine25"	"Starte Menüsystem..."
"asw_SynTekScrollLine26"	"."
"asw_SynTekSecurityCam"	"Überwachungskamera"
"asw_SynTekSecurityCam1"	"Überwachungskamera 1"
"asw_SynTekSecurityCam2"	"Überwachungskamera 2"
"asw_SynTekSecurityCam3"	"Überwachungskamera 3"
"asw_SynTekTurret1"	"Geschützturm 1"
"asw_SynTekTurret2"	"Geschützturm 2"
"asw_SynTekTurret3"	"Geschützturm 3"
"asw_turret_text_top_left"	"KOLONIE-SICHERHEITSCHECK\nVERWENDE CODE FÜR MANUELLEN EINGRIFF ALPHA 5/34\n\nINTERNER CHECK DER GESCHÜTZTURMSYSTEME\n0X83 0x32 0x17 0x02 0x82\n0x18 0x53 0x5A 0x70 0x12\n\nZIEL-SICHERHEITSCHECK:\nDEAKTIVIERT"
"asw_turret_text_top_right"	"FERNGESTEUERTES SICHERHEITSSYSTEM V264.3C\n\nZUR VERFÜGUNG GESTELLT VON SYNTEK SECURITY, EINE\nVOLLSTÄNDIGE TOCHTERGESELLSCHAFT VON\nSYNTEK MEGACORPORATION, INC.\n\nZIELVERFOLGUNG AKTIV\nGESCHÜTZLAUF: OK"
"asw_SynTekMail"	"E-Mail"
"asw_SynTekMailInbox"	"Posteingang"
"asw_SynTekMailOutbox"	"Gesendet"
"asw_SynTekMailFrom"	"Von"
"asw_SynTekMailDate"	"Datum"
"asw_SynTekMailSubject"	"Betreff"
"asw_SynTekMailAccount"	"E-Mail-Konto:"
"asw_SynTekNews"	"Neuigkeiten"
"asw_SynTekStocks"	"Aktien"
"asw_SynTekAtmospherics"	"Atmosphärenbericht"
"asw_SynTekAtmosphere"	"Atmosphäre"
"asw_SynTekPlantStatus"	"Anlagenzustand"
"asw_SynTekBackButton"	"Zurück"
"asw_SynTekMoreButton"	"Mehr"
"asw_SynTekDocs"	"Kritische Daten"
"asw_SynTekDownloadDocs"	"Kritische Daten herunterladen"
"asw_SynTekDownloadingDocs"	"Kritische Daten werden heruntergeladen"
"asw_SynTekDownloadDocsComplete"	"Download vollständig"
"asw_SynTekReactorLabel"	"Reaktor"
"asw_SynTekHeatExchangerLabel"	"Wärmetauscher"
"asw_SynTekCoolingTowerLabel"	"Kühlturm"
"asw_SynTekDrivingPistonsLabel"	"Antriebskolben"
"asw_SynTekTemperaturesLabel"	"TEMPERATUREN:"
"asw_SynTekPrimaryCoolantLabel"	"Primäres Kühlmittel"
"asw_SynTekSecondaryCoolantLabel"	"Sekundäres Kühlmittel"
"asw_SynTekEmergencyCoolantLabel"	"Notkühlmittel"
"asw_SynTekEnergyBusLabel"	"Leistungsabgabe der Hauptleitung:"
"asw_SynTekReactorStatusLabel"	"REAKTOR"
"asw_SynTekReactorOnlineLabel"	"IN BETRIEB"
"asw_SynTekReactorOfflineLabel"	"AUßER BETRIEB"
"asw_SynTekEnergyNameLabel"	"ENERGIEABGABE"
"asw_SynTekEfficiencyNameLabel"	"BETRIEBS-\nEFFIZIENZ"
"asw_stock_symbol"	"Symbol"
"asw_stock_name"	"Name"
"asw_stock_value"	"Wert"
"asw_stock_change"	"Änderung"
"asw_stock_volume"	"Volumen"
"asw_weather_temp"	"Temperatur:"
"asw_weather_wind"	"Windgeschwindigkeit:"
"asw_weather_pressure"	"Luftdruck:"
"asw_weather_humidity"	"Relative Luftfeuchtigkeit:"
"asw_weather_cloud"	"Wolkendecke:"
"asw_weather_vis"	"Sichtweite:"
"asw_weather_weather"	"Aktuelles Wetter:"
"asw_weather_temp_r"	"%s1 Kelvin"
"asw_weather_wind_r"	"%s1 m/s"
"asw_weather_pressure_r"	"%s1 hPa"
"asw_weather_humidity_r"	"%s1%"
"asw_weather_broken_cloud_r"	"Aufgelockerte Bewölkung in %s1m Höhe"
"asw_weather_few_cloud_r"	"Wenige Wolken in %s1m Höhe"
"asw_weather_vis_r"	"%s1 km"
"asw_weather_weather_light"	"Leichter Schneefall"
"asw_weather_weather_moderate"	"Mäßiger Schneefall"
"asw_weather_warning"	"WARNUNG: Mitarbeiter müssen auf die korrekte Vorgehensweise für Oberflächenarbeiten achten. Schneeraupen sind nur für autorisiertes Personal verfügbar, wenn die Aufgaben es erfordern. SynTek Megacorporation haftet nicht für durch Atmosphärenexposition verursachte Verletzungen, eingeschlossen aber nicht beschränkt auf Unterkühlung, Erstickung und Verätzungen."
"asw_SynTekFlagLabel0"	"Ende"
"asw_SynTekFlagLabel1"	"Sperren"
"asw_SynTekFlagLabel2"	"Dämpfung"
"asw_SynTekFlagLabel3"	"Turbinenüberlastung"
"asw_SynTekFlagLabel4"	"Turbinenausfall"
"asw_SynTekFlagLabel5"	"Überlastung des Wärmetauschers"
"asw_SynTekFlagLabel6"	"Ausfall des Wärmetauschers"
"asw_SynTekFlagLabel7"	"Leck des primären Kühlmittels"
"asw_SynTekFlagLabel8"	"Leck des sekundären Kühlmittels"
"asw_SynTekFlagLabel9"	"Leck des Notkühlmittels"
"asw_SynTekFlagLabel10"	"Subraumverbindung"
"asw_SynTekFlagLabel11"	"SynTek HQ-Verbindung"
"asw_access_pda"	"PDA aufrufen"
"asw_MailAccount"	"E-Mail-Konto:"
"asw_MailBodyLabel"	"Nachricht:"
// skills
"asw_leadership"	"Führung"
"asw_vindicator"	"Vindicator-Schaden"
"asw_incendiarym"	"Brandminen"
"asw_autogunsk"	"Autogun-Schaden"
"asw_stopping"	"Mannstoppwirkung"
"asw_piercingbullets"	"Panzerbrechende Kugeln"
"asw_healing"	"Heilung"
"asw_xenowound"	"Verseuchungsheilmittel"	//"Xenowound Specialization"
"asw_combatdrugs"	"Kampfdrogen"
"asw_hacking"	"Hacken"
"asw_scanner"	"Scanner"
"asw_engineering"	"Technik"
"asw_accuracy_skill"	"Schadensbonus"
"asw_grenades"	"Sprengstoffbonus"
"asw_health"	"Gesundheitsbonus"
"asw_melee"	"Nahkampfbonus"
"asw_reloading"	"Nachladebonus"
"asw_agility"	"Geschwindigkeitsbonus"
"asw_points"	"Punkte"
"asw_unspent_points"	"Fähigkeitspunkte: %s1"
"asw_undo_tooltip"	"Rückgängig"
"asw_undo_tooltip_desc"	"In dieser Mission verwendete Fähigkeitspunkte rückgängig machen"
"asw_points_tooltip"	"Unbenutzte Fähigkeitspunkte"
"asw_points_tooltip_desc"	"Verwende Fähigkeitspunkte, um die Fähigkeiten der Soldaten zu verbessern.\nDem Marine wurden bereits %s1 Fähigkeitspunke zugewiesen."
// skill descriptions
"asw_leadership_desc"	"Erhöht den verursachten Schaden und die Schadensresistenz von nahen Teamkameraden."
"asw_vindicator_desc"	"Erhöht den durch den Vindicator verursachten Schaden."
"asw_incendiarym_desc"	"Erhöht Größe und Dauer der\ndurch Brandminen verursachten Napalmfeuer."
"asw_autogunsk_desc"	"Erhöht den durch Autogun und Minigun verursachten Schaden."
"asw_stopping_desc"	"Erhöht die Chance, dass Schüsse des Marines\ndie Schwarmdrohnen betäuben."
"asw_piercingbullets_desc"	"Erlaubt es Kugeln Feinde zu durchschlagen\nund auf der anderen Seite wieder auszutreten."
"asw_healing_desc"	"Erhöht die Heilungskraft von heilenden\nGegenständen und die Gesamtmenge, die getragen werden kann."
"asw_xenowound_desc"	"Erlaubt dem Sanitäter, verseuchte Marines zu heilen\nund so die Dauer der Verseuchung zu reduzieren."
"asw_combatdrugs_desc"	"Boosts effectiveness of adrenaline\nwhen used by your squad."
"asw_hacking_desc"	"Reduziert die benötigte Zeit beim Hacken\nund beim Downloaden von kritischen Daten."
"asw_scanner_desc"	"Erhöht Reichweite und Frequenz des Bewegungsmelders."
"asw_engineering_desc"	"Speeds up welding and Sentry Gun\nsetup for all nearby squad mates. Improves fire rate of prototype rifle"
"asw_accuracy_skill_desc"	"Erhöht den durch die meisten\nStandardwaffen verursachten Schaden."
"asw_grenades_desc"	"Erhöht die Effektivität aller\nExplosivwaffen."
"asw_health_desc"	"Erhöht die Gesamtgesundheit des Marines."
"asw_melee_desc"	"Erhöht den durch Nahkampfattacken und -waffen\ndes Marines verursachten Schaden."
"asw_reloading_desc"	"Verringert die Nachladezeit für alle Waffen."
"asw_agility_desc"	"Erhöht die Bewegungsgeschwindigkeit des Marines."
"asw_name_sarge"	"Sarge"
"asw_name_jaeger"	"Jaeger"
"asw_name_wildcat"	"Wildcat"
"asw_name_wolfe"	"Wolfe"
"asw_name_faith"	"Faith"
"asw_name_bastille"	"Bastille"
"asw_name_crash"	"Crash"
"asw_name_flynn"	"Flynn"
"asw_name_vegas"	"Vegas"
"asw_bio_sarge"	"Joseph Conrad ist ein zäher und erfahrender Soldat. Er ist einer der wenigen, die die großräumige Invasion des Schwarms überlebt haben. Eine Erfahrung, die ihn zu dem zielorientierten Mann gemacht hat, der er heute ist. Er ist ein starker Befehlsherr, er führt beispielhaft voran, arbeitet aber auch mit der nicht so sanften verbalen Anwendung der \"Fuß gegen Hintern\"-Methode. Er kennt seine Einheit sehr gut und hält sie immer unter einem gewissen Druck, sodass diese immer ihr Bestes gibt."
"asw_bio_jaeger"	"Karl Jaeger ist der Sohn eines Sohnes eines Sanitäters. Bis zu seinen durch Krieg gehärteten Knochen besteht er aus dem Militär. Er ist eine vorwärtsdrängende Tötungsmaschine mit einem echten Kampfgeist. Er glaubt an einen seelenbefreienden Spaß am Kampf und er hat schon immer gedacht, dass er eines Tages im Dienst sterben wird. Und wenn das passiert, naja, er kann es sich gar nicht besser vorstellen."
"asw_bio_wildcat"	"In ihrer Jugend hat Wildcat nie erwartet, dass sie in die Fußstapfen ihrer Militärfamilie treten würde. In der Schule hat sie immer vom Geschäftsleben, teuren Anzügen und einem netten Eckbüro geträumt. Aber der Schwarm hat ihr das genommen. Jeder aus ihrer Altersgruppe, der in der Lage war, wurde in die hoffnungslose Verteidigung der Kolonien gedrängt. Als sie 25 wurde, waren ihre Beweggründe verloren. Die Kolonien gab es nur noch zu einem Bruchteil und Ihre Familienmitglieder waren entweder tot oder irgendwohin zerstreut. Wildcat lies sich zu einer Einheit von Elitesoldaten umtransferieren, um dort den Kampf fortzusetzen."
"asw_bio_wolfe"	"Wolfe ist ein ehemaliger Häftling, welcher Soldat wurde. Bei seiner letzten Urteilsverkündung gab der Richter ihm die Wahl: Gefängnis oder die IAF. Es war die Chance die er brauchte, um sein Leben wieder in den Griff zu bekommen. Im Ausbildungslager erwies er sich als ausgezeichnet, so konnte er die anderen einberufenen Männer mit Leichtigkeit in Disziplinen wie dem Nahkampf und der Demontage von Spezialordonanz besiegen. Als seine Strafzeit abgelaufen war, bemerkte er erst, wie er das Leben im Militär mochte und außerdem, wie gut er darin war. Wegen letzterem wurde ihm dann sogar eine Position in den Spezialeinheiten angeboten."
"asw_bio_faith"	"Faith besitzt das Herz und die Seele eines Sanitäters. Sie ist hier, um den Menschen zu helfen und sie glaubt daran, dass die IAF die Alliierten Systeme gegen feindliche Angriffe der Aliens schützen muss. Auch wenn sie schon viel mitgemacht hat, ist sie dennoch immer noch von den Tragödien, die sie sieht, betroffen und nimmt Verluste persönlich. Sie kümmert sich zutiefst um das Wohlergehen ihres Teams."
"asw_bio_bastille"	"Leon Bastille wurde als Sohn eines politischen Gefangenen auf einem Gefängnisplaneten geboren; Mit einem Wechsel in der Politik wurde auch er und seine Familie freigelassen. Sein Umfeld war von Schwarzmarktlern beherrscht und er hatte somit genügend Gelegenheit, allerhand medizinische Fähigkeiten zu erlernen. Er erhielt zudem eine grundfeste, wenn auch informelle, akademische Bildung (im Gefängnis waren allerlei Philosophen, Autoren, Erzieher, Dichter und Priester). Bastille misstraut jedermann, ist jedoch ein absolut ausgezeichneter Doktor auf dem Schlachtfeld."
"asw_bio_crash"	"David Murphy, welcher schon in der Technikschule ein angebliches Hackergenie war, hat nicht lange gebraucht, um auf der falschen Seite des Gesetzes zu landen. Im Alter von 21 Jahren war er verantwortlich für den bekannten Starbase-Systemabsturz, was die Handelsvereine Millionen an verlorenen Krediten gekostet hat. Murphy muss durch seine Verurteilung nun in den IAF dienen."
"asw_bio_flynn"	"Flynns Gesicht ist durch eine Narbe entstellt, welche quer über das linke Auge verläuft. Er ist ein geborener rauer Kämpfer, aufgewachsen in einer harten Welt, in welcher sich zwei Parteien aufgrund einer uralten Fehde bekämpfen, zerrüttet durch einen ewigen Bürgerkrieg. Straßenkämpfe, Guerillataktiken und der unsaubere Kampf sind sein Element. Am wohlsten fühlt er sich mit sich mit großen Waffen. Je größer, desto besser.  Er spricht nicht viel, sein eines gutes Auge ist aber stets wachsam."
"asw_bio_vegas"	"Vegas hat ein regelrecht geniales Talent fürs Zählen und Merken, eine Fähigkeit, die er an vielen Poker- und Blackjack-Tischen in vielen Casinos erfolgreich benutzt hat. Leider ist das Glück flatterhaft und nachdem er massive Schulden angesammelt und einige wichtige Leute verärgert hat, musste er aussteigen. Vegas trat der IAF bei um das Geld für seine Schulden zu verdienen (oder wenigstens ein Grundkapital, um den Rest zurückzugewinnen) und um der Rache der Gläubiger zu entkommen."
"asw_nomarines"	"Keine Marines ausgewählt."
"asw_spectating"	"BEOBACHTEN"
"asw_spectating_marine"	"BEOBACHTE %s1"
"asw_spectating_player"	"BEOBACHTE %s2 (%s1)"
"asw_missionl"	"Mission"
"asw_missing"	"MISSION"
"asw_roster"	"DIENSTPLAN"
"asw_equip"	"AUSRÜSTEN"
"asw_options"	"OPTIONEN"
"asw_start_campaign"	"Neue Kampagne beginnen"
"asw_load_campaign"	"Gespeicherte Kampagne laden"
"asw_single_mission"	"Einzelmission"
"asw_youhavenomarines"	"Wähle einen Marine aus der Liste aus um an diesem Einsatz teilzunehmen."
"asw_revive_marines"	"Marines wiederbeleben"
"asw_revive_warning"	"Tote Marines wiederzubeleben ist ein teurer Vorgang für die IAF und wird eine permanente Negativeintragung in deiner Akte hinterlassen. Bist du dir sicher, dass due diese Prozedur autorisieren möchtest?"
"asw_marines_revived"	"Tote Marines wiederbelebt."
"asw_button_cancel"	"Abbrechen"
"asw_hacking_tumbler_title"	"EXEC: Sec-Override v4.00774"
"asw_hacking_tumbler_status"	"ZUGRIFFSSTATUS"
"asw_hacking_access_logged"	"ZUGRIFFSVERSUCH AUFGEZEICHNET"
"asw_hacking_tumbler_alignment"	"TEILANLAGEN-PROZESSABGLEICH"
"asw_hacking_tumbler_rejected_1"	"FEHLER: RECHTE FÜR DAS SYSTEMVERZEICHNIS VOM ZUGRIFFSPUNKT ABGEWIESEN. FEHLERCODE 1."
"asw_hacking_tumbler_rejected_2"	"FEHLER: RECHTE FÜR DAS SYSTEMVERZEICHNIS VOM SYNTEK SICHERHEITSINTERFACE A ABGEWIESEN. FEHLERCODE 58."
"asw_hacking_tumbler_rejected_3"	"FEHLER: RECHTE FÜR DAS SYSTEMVERZEICHNIS VOM SYNTEK SICHERHEITSINTERFACE B ABGEWIESEN. FEHLERCODE 57."
"asw_hacking_tumbler_rejected_4"	"FEHLER: RECHTE FÜR DAS SYSTEMVERZEICHNIS DURCH DEN RPC-GATEWAY ABGEWIESEN. FEHLERCODE 54."
"asw_hacking_tumbler_rejected_5"	"FEHLER: RECHTE FÜR DAS SYSTEMVERZEICHNIS DURCH RAM-DURCHSUCHUNG ABGEWIESEN. FEHLERCODE 64."
"asw_hacking_tumbler_rejected_6"	"FEHLER: RECHTE FÜR DAS SYSTEMVERZEICHNIS DURCH DIE PROZESSÜBERWACHUNG ABGEWIESEN. FEHLERCODE 65."
"asw_hacking_tumbler_rejected_7"	"FEHLER: RECHTE FÜR DAS SYSTEMVERZEICHNIS DURCH DEN INTERNEN NETZWERKZUGANG ABGEWIESEN. FEHLERCODE 81."
"asw_hacking_tumbler_rejected_8"	"FEHLER: RECHTE FÜR DAS SYSTEMVERZEICHNIS DURCH DEN BETRIEBSSYSTEM-KERNEL ABGEWIESEN. FEHLERCODE 904."
"asw_computer_insufficient_rights"	"Unzureichende Rechte, um auf dieses SynTek\nMegacorporation Terminal zuzugreifen. Dieser Zugriffsversuch\nund Ihre Transponder-ID wurden für eine Überprüfung durch das SynTek-Sicherheitspersonal aufgezeichnet."
"asw_computer_access_denied"	"ZUGRIFF\nVERWEIGERT"
"asw_access_granted"	"Zugriff gewährt"
"asw_log_off"	"Abmelden"
"asw_override"	"Überbrückung"
"asw_status_block_0"	"ZUGRIFFSPUNKT"
"asw_status_block_1"	"SSI"
"asw_status_block_2"	"FERNAUTORISIERUNG"
"asw_status_block_3"	"RPC-GATEWAY"
"asw_status_block_4"	"ZRAM-DURCHSUCHUNG"
"asw_status_block_5"	"PROZESSÜBERWACHUNG"
"asw_status_block_6"	"INTERNER NETZWERKKNOTEN"
"asw_status_block_7"	"BETRIEBSSYSTEM-KERNEL"
"asw_difficulty"	"Schwierigkeitsgrad:"
"asw_difficulty_insane"	"Wahnsinnig"
"asw_difficulty_hard"	"Schwer"
"asw_difficulty_normal"	"Normal"
"asw_difficulty_easy"	"Leicht"
"asw_difficulty_campaign"	"Feldzug"
"asw_difficulty_mission"	"Einzelmission"
"asw_difficulty_carnage"	"Gemetzel"
"asw_difficulty_uber"	"Extrem"
"asw_difficulty_hardcore"	"Hardcore"
"asw_difficulty_insane_desc"	"Falls deine Einheit den Feldzug auf \"Schwer\" geschafft hat, solltest du \"Wahnsinnig\" als Herausforderung probieren! Gegner bewegen sich mit erhöhter Geschwindigkeit, fügen mehr Schaden zu und sind schwerer zu töten."
"asw_difficulty_hard_desc"	"Falls du schon einmal Alien Swarm gespielt hast, wähle diese Einstellung. Gegner bewegen sich schneller und sind schwerer zu töten. Team-Taktiken werden wichtiger um zu Überleben. Dafür gibt es aber auch mehr Erfahrungspunkte."
"asw_difficulty_normal_desc"	"Wenn du noch wenig Erfahrung mit Alien Swarm hast, empfiehlt sich \"Normal\"."
"asw_difficulty_easy_desc"	"Wenn du sehr wenig Erfahrung mit Computerspielen hast, probier mal \"Leicht\" aus. Gegner bewegen sich langsamer und sind einfacher zu erledigen."
"asw_mode_normal_tt"	"Schliesse Einsätze im Einzelspieler-\nmodus ab, um zusätzliche Spielarten freizuschalten."
"asw_mode_carnage_tt"	"Es gibt mehr Schwarmdrohnen,\ndafür halten sie aber weniger aus."
"asw_mode_uber_tt"	"Bekämpft größere und stärkere Schwarmdrohnen."
"asw_mode_hardcore_tt"	"Tödliche Parasiten, keine Zielhilfe,\nvoller Schaden bei Freundbeschuss."
"asw_mission_difficulty"	"Schwierigkeitsgrad %s1 %s2 %s3 %s4 %s5"
"asw_cheated"	"CHEATS BENUTZT"
"asw_unofficial_map"	"Du kannst dir nur auf offiziellen Karten Erfahrung verdienen."
"asw_select_campaign"	"Feldzug auswählen"
"asw_select_saved_campaign"	"Gespeicherten Feldzug auswählen"
"asw_select_single_mission"	"Einzelmission auswählen"
"ASWMainMenu_Tutorial"	"IAF-Training"
"ASWMainMenu_Singleplayer"	"Einzelspieler"
"asw_menu_start_new_campaign"	"Neuen Feldzug beginnen"
"asw_menu_load_campaign"	"Gespeicherten Feldzug laden"
"asw_menu_single_mission"	"Einzelmission"
"asw_menu_back"	"Zurück"
"asw_menu_IAF_training"	"IAF-Training"
"asw_menu_singleplayer"	"Einzelspieler"
"asw_menu_find_server"	"Server suchen"
"asw_menu_create_server"	"Server erstellen"
"asw_vote_server"	"Abstimmung starten"
"asw_mission_not_installed"	"Mission nicht installiert"
"asw_campaign_not_installed"	"Feldzug nicht installiert"
"asw_menu_friends"	"Freunde"
"asw_menu_options"	"Optionen"
"asw_menu_message_log"	"Nachrichtenprotokoll"
"asw_menu_quit"	"Beenden"
"asw_menu_resume"	"Spiel fortsetzen"
"asw_menu_disconnect"	"Trennen"
"asw_menu_player_list"	"Spielerliste"
"asw_menu_database"	"IAF-Datenbank"
"asw_swarmopedia"	"SCHWARMOPÄDIE"
"aswmenu_notutorial_title"	"Nachricht vom IAF-Kommando"
"aswmenu_notutorial_body"	"Bevor du in einen vollen Einsatz gehst, empfiehlt das IAF-Kommando die\nAbsolvierung des IAF-Trainings, damit du weißt wie due eine IAF-Marine-Einheit\neffektiv befehligen kannst. Missverständnisse beim Vorrücken oder Positionhalten könnten\nzu unnötigen Opfern führen."
"aswmenu_notutorial_skip"	"Ignorieren"
"aswmenu_notutorial_start"	"IAF-Training beginnen"
"asw_show_all_files"	"Alle Karten anzeigen"
"asw_chooser_close"	"Schließen"
"asw_delete_save"	"Löschen"
"asw_wire_1_label"	"Antriebsladung:"
"asw_wire_2_label"	"Antrieb 2:"
"asw_wire_3_label"	"Antrieb 3:"
"asw_wire_4_label"	"Antrieb 4:"
"asw_bleeding"	"- Blutung -"
"asw_objectives"	"Ziele"
"asw_objectives_list"	"- ZIELE -"
"asw_objective_titlef"	"%s1"
"asw_weapon_tooltip_activate"	"Linksklick zum Aktivieren"
"asw_weapon_tooltip_change"	"Linksklick zum Ändern"
"asw_weapon_tooltip_increase"	"LINKSKLICK UM FÄHIGKEIT ZU VERBESSERN"
"asw_weapon_details_firepower"	"Schaden pro Schuss"
"asw_weapon_details_firerate"	"Feuerrate"
"asw_weapon_details_reload"	"Nachladegeschwindigkeit"
"asw_weapon_details_clipsize"	"Kapazität"
"asw_weapon_details_altfire"	"Alternativer Waffenmodus"
"asw_weapon_details_attributes"	"Attribute"
"asw_weapon_details_notes"	"Hinweise"
"asw_weapon_details_required_level"	"Freischaltung bei Level"
"asw_weapon_details_seconds"	"Sek."
"asw_no_ammo"	"- KEINE MUNITION -"
"asw_low_ammo"	"- WENIG MUNITION -"
"asw_weapon_null_line"	""
"asw_weapon_empty"	"Unbewaffnet"
"asw_weapon_altfire_none"	"Keiner"
"asw_weapon_altfire_NA"	"Nicht verfügbar"
"asw_weapon_rifle"	"Sturmgewehr"
"asw_weapon_rifle_altfire"	"Granaten"
"asw_weaponl_rifle"	"22A3-1 Sturmgewehr"
"asw_weapon_rifle_attributes"	""
"asw_weapon_sniper_rifle"	"Scharfschützengewehr"
"asw_weapon_sniper_rifle_altfire"	"Verbesserte Zieldarstellung"
"asw_weaponl_sniper_rifle"	"AVK-36 Scharfschützengewehr"
"asw_weapon_sniper_rifle_attributes"	"Panzerbrechende Kugeln"
"asw_weapon_ammo_bag"	"Munitionstasche"
"asw_weaponl_ammo_bag"	"IAF-Munitionstasche"
"asw_weapon_ammo_bag_attributes"	"Bestimmte Munition auffüllen"
"asw_weapon_ammo_satchel"	"Munitionsbehälter"
"asw_weaponl_ammo_satchel"	"IAF-Munitionsbehälter"
"asw_weapon_ammo_satchel_attributes"	""
"asw_weapon_autogun"	"Autogun"
"asw_weapon_autogun_attributes"	"Zielhilfe, langsame Bewegung"
"asw_weaponl_autogun"	"S23A SynTek Autogun"
"asw_weapon_chainsaw"	"Kettensäge"
"asw_weaponl_chainsaw"	"Kettensäge"
"asw_weapon_chainsaw_attributes"	"Unbegrenzte Munition"
"asw_weapon_fire_extinguisher"	"Feuerlöscher"
"asw_weaponl_fire_extinguisher"	"Feuerlöscher"
"asw_weapon_fire_extinguisher_attributes"	"Löscht Feuer"
"asw_weapon_flamer"	"Flammenwerfer"
"asw_weaponl_flamer"	"M868 Flammenwerfer"
"asw_weapon_flamer_altfire"	"Feuerlöscher"
"asw_weapon_flamer_attributes"	"Bringt Dinge zum Brennen. Nur mit Vorsicht nutzen."
"asw_weapon_flares"	"Gefechtsfackeln"
"asw_weaponl_flares"	"SM75-Gefechtsfackeln"
"asw_weapon_flares_attributes"	"Bietet einen Bonus auf die Zielhilfe"
"asw_weapon_flashlight"	"Taschenlampe"
"asw_weaponl_flashlight"	"Taschenlampenzusatz"
"asw_weapon_flashlight_attributes"	"Passiv"
"asw_weapon_grenades"	"Granaten"
"asw_weaponl_grenades"	"Handgranaten"
"asw_weapon_grenades_attributes"	"Explosionsschaden"
"asw_weapon_freeze_grenades"	"Frostgranaten"
"asw_weaponl_freeze_grenades"	"Frostgranaten"
"asw_weapon_freeze_grenades_attributes"	"Großer Radius"
"asw_weapon_grenade_launcher"	"Granatwerfer"
"asw_weaponl_grenade_launcher"	"Granatwerfer"
"asw_weapon_grenade_launcher_attributes"	"Explosionsschaden"
"asw_weapon_night_vision"	"Nachtsichtgerät"
"asw_weaponl_night_vision"	"MNV34 Nachtsichtgerät"
"asw_weapon_night_vision_attributes"	"Wiederaufladbar"
"asw_weapon_medsat"	"Erste-Hilfe-Kasten"
"asw_weaponl_medsat"	"IAF-Erste-Hilfe-Kasten"
"asw_weapon_medsat_attributes"	"Schnell einsatzbereit"
"asw_weapon_healgun"	"Sanitätswaffe"
"asw_weaponl_healgun"	"IAF-Sanitätswaffe"
"asw_weapon_healgun_altfire"	"Selbst heilen"
"asw_weapon_healgun_attributes"	"Mobile Heilung"
"asw_weapon_heal_grenade"	"Medkit"
"asw_weaponl_heal_grenade"	"IAF-Medkit"
"asw_weapon_heal_grenade_attributes"	"Gruppenheilung"
"asw_weapon_medkit"	"Selbstheilungspaket"
"asw_weaponl_medkit"	"IAF-Selbstheilungspaket"
"asw_weapon_medkit_attributes"	"Einweg"
"asw_weapon_mines"	"Minen"
"asw_weaponl_mines"	"M478-Annäherungsbrandminen"
"asw_weapon_mines_attributes"	"Feuerwand"
"asw_weapon_laser_mines"	"Laser-Tretmine"
"asw_weaponl_laser_mines"	"ML30 Laser-Tretmine"
"asw_weapon_laser_mines_attributes"	"An Wänden montierbar"
"asw_weapon_t75"	"T75"
"asw_weaponl_t75"	"T75 Sprengstoff"
"asw_weapon_t75_attributes"	"Sprengt Türen"
"asw_weapon_damage_amp"	"Schadensverstärker"
"asw_weaponl_damage_amp"	"X33 Schadensverstärker"
"asw_weapon_damage_amp_attributes"	"x2 Schadensaura"
"asw_weapon_hornet_barrage"	"Raketen-Sperrfeuer"
"asw_weaponl_hornet_barrage"	"Raketen-Sperrfeuer"
"asw_weapon_hornet_barrage_attributes"	"Zielsuchende Raketen"
"asw_weapon_smart_bomb"	"Lenkbombe"
"asw_weaponl_smart_bomb"	"MTD6 Lenkbomben"
"asw_weapon_smart_bomb_attributes"	"Raketensturm, Einmalige Benutzung"
"asw_weapon_mining_laser"	"Bergbau-Laser"
"asw_weaponl_mining_laser"	"Bergbau-Laser"
"asw_weapon_mining_laster_attributes"	"Zerstört Geröll"
"asw_weapon_pdw"	"PDW"
"asw_weaponl_pdw"	"K80 Persönliche Defensivwaffe"
"asw_weapon_pdw_attributes"	"Hoher Munitionsverbrauch"
"asw_weapon_pistol"	"Doppel-Pistolen"
"asw_weaponl_pistol"	"M73 Doppel-Pistolen"
"asw_weapon_pistol_attributes"	"Munitionseffizient"
"asw_weapon_prifle"	"Prototyp-Gewehr"
"asw_weapon_prifle_altfire"	"Elektroschock-Granaten"
"asw_weaponl_prifle"	"22A7-Z Prototyp-Gewehr"
"asw_weapon_prifle_attributes"	"Zielhilfe"
"asw_weapon_railgun"	"Schienengewehr"
"asw_weaponl_railgun"	"Präzisions-Lasergewehr"
"asw_weapon_railgun_attributes"	"Panzerbrechende Kugeln"
"asw_weapon_vindicator"	"Vindicator"
"asw_weapon_vindicator_altfire"	"Brandgranaten"
"asw_weaponl_vindicator"	"M42 Vindicator"
"asw_weapon_vindicator_attributes"	"Hoher Schaden, Für nähere Ziele geeignet"
"asw_weapon_tesla_gun"	"Tesla-Kanone"
"asw_weaponl_tesla_gun"	"IAF-Tesla-Kanone"
"asw_weapon_tesla_gun_attributes"	"Betäubt, Kein Freundbeschuss"
"asw_weapon_sentry"	"Minigun-Wächter"
"asw_weapon_sentry_attributes"	""
"asw_weaponl_sentry"	"IAF-Erweiterter Wächter"
"asw_weapon_sentry_flamer"	"Brandgeschoss-Wächter"
"asw_weaponl_sentry_flamer"	"IAF Brandgeschoss-Wächter"
"asw_weapon_sentry_flamer_attributes"	"Zündet an, schnelle Zielerfassung"
"asw_weapon_sentry_cannon"	"Kanonengeschütz-Wächter"
"asw_weaponl_sentry_cannon"	"IAF-Hochbeschleunigungs-Wächter"
"asw_weapon_sentry_cannon_attributes"	"Hohe Reichweite, Umgebungsschaden"
"asw_weapon_sentry_freeze"	"Frost-Wächter"
"asw_weaponl_sentry_freeze"	"IAF-Gefrier-Wächter"
"asw_weapon_sentry_freeze_attributes"	"Friert Ziele ein, Schnelle Zielerfassung"
"asw_weapon_tesla_trap"	"Tesla-Falle"
"asw_weaponl_tesla_trap"	"IAF-Teslaspule"
"asw_weapon_tesla_trap_attributes"	"Betäubt Feinde in der Nähe"
"asw_weapon_stim"	"Adrenalin"
"asw_weaponl_stim"	"Adrenalin"
"asw_weapon_stim_attributes"	"Vorrübergehende Zeitlupe"
"asw_weapon_electrified_armor"	"Elektroschock-Rüstung"
"asw_weaponl_electrified_armor"	"v45 Elektrisch geladene Rüstung"
"asw_weapon_electrified_armor_attributes"	"Stoppt Parasitenbefall, betäubt Feinde in der Umgebung"
"asw_weapon_normal_armor"	"Schwere Rüstung"
"asw_weaponl_normal_armor"	"l3a Taktische Schwere Rüstung"
"asw_weapon_normal_armor_attributes"	"20%% weniger Schaden, passiv"
"asw_weapon_fist"	"Powerfaust"
"asw_weaponl_fist"	"IAF-Powerfaust-Aufsatz"
"asw_weapon_fist_attributes"	"x2 Nahkampfschaden, passiv"
"asw_weapon_blink"	"Teleporterpack"
"asw_weaponl_blink"	"Versetzungs- 'Flimmer' Paket"
"asw_weapon_blink_attributes"	"Wiederaufladbar"
"asw_weapon_jump_jet"	"Raketenrucksack"
"asw_weaponl_jump_jet"	"Raketenrucksack mit geringer Reichweite"
"asw_weapon_jump_jet_attributes"	"Zerstreut Gegner bei der Landung"
"asw_weapon_shotgun"	"Schrotflinte"
"asw_weaponl_shotgun"	"Model 35 Schrotflinte"
"asw_weapon_shotgun_attributes"	"Hoher Schaden, für nähere Entfernungen geeignet"
"asw_weapon_welder"	"Schweißgerät"
"asw_weaponl_welder"	"Handschweißgerät"
"asw_weapon_welder_attributes"	"Versiegelt und öffnet Türen"
"asw_weapon_flechette"	"Flechetwerfer"
"asw_weapon_flechette_attributes"	"Fernzündung"
"asw_weapon_ricochet"	"Ricochet-Gewehr"
"asw_weapon_ricochet_attributes"	"Abprallende Geschosse"
"asw_weapon_minigun"	"Minigun"
"asw_weapon_minigun_altfire"	"Andrehen der Läufe"
"asw_weaponl_minigun"	"IAF-Minigun"
"asw_weapon_minigun_attributes"	"Breite Streuung, Langsame Bewegung"
"asw_weapon_bait"	"Köder"
"asw_weaponl_bait"	"Schwarmköder"
"asw_weapon_bait_attributes"	"Fleischkuchen"
"asw_take_weapon_format"	"%s1 nehmen"
"asw_swap_weapon_format"	"Gegen %s1 eintauschen"
"asw_t75_arm"	"T75 SCHARF SCHALTEN"
"asw_t75_armed"	"T75 SCHARF"
"asw_take_ammo_rifle"	"Gewehrmunition nehmen"
"asw_take_ammo_autogun"	"Autogun-Munition nehmen"
"asw_take_ammo_shotgun"	"Schrotmunition nehmen"
"asw_take_ammo_vindicator"	"Vindicator-Munition nehmen"
"asw_take_ammo_flamer"	"Flammenwerfer-Munition nehmen"
"asw_take_ammo_pistol"	"Pistolenmunition nehmen"
"asw_take_ammo_mining_laser"	"Bergbau-Laser-Munition nehmen"
"asw_take_ammo_railgun"	"Lasermunition nehmen"
"asw_take_ammo_chainsaw"	"Kettensägenbenzin nehmen"
"asw_take_ammo_pdw"	"PDW-Munition nehmen"
// powerups
"asw_take_pow_fire_bullets"	"Feuer-Booster nehmen"
"asw_take_pow_freeze_bullets"	"Frost-Booster nehmen"
"asw_take_pow_elec_bullets"	"Schock-Booster nehmen"
"asw_take_pow_chem_bullets"	"Chemie-Booster nehmen"
"asw_take_pow_explo_bullets"	"Explosiv-Booster nehmen"
"asw_take_pow_inc_speed"	"Geschwindigkeitsbooster nehmen"
"asw_ammo_rifle"	"Gewehrmunition"
"asw_ammo_autogun"	"Autogun-Munition"
"asw_ammo_shotgun"	"Schrotmunition"
"asw_ammo_vindicator"	"Vindicator-Munition"
"asw_ammo_flamer"	"Flammenwerfer-Muniton"
"asw_ammo_pistol"	"Pistolenmunition"
"asw_ammo_mining_laser"	"Bergbau-Laser-Munition"
"asw_ammo_railgun"	"Lasermunition"
"asw_ammo_chainsaw"	"Kettensägenbenzin"
"asw_ammo_pdw"	"PDW-Munition"
"asw_ammo_rifle_full"	"Volle Gewehrmagazine"
"asw_ammo_autogun_full"	"Volle Autogun-Magazine"
"asw_ammo_shotgun_full"	"Volle Schrotmagazine"
"asw_ammo_vindicator_full"	"Volle Vindicator-Magazine"
"asw_ammo_flamer_full"	"Volle Flammenwerfer-Magazine"
"asw_ammo_pistol_full"	"Volle Pistolenmagazine"
"asw_ammo_mining_laser_full"	"Volle Bergbau-Laser-Magazine"
"asw_ammo_railgun_full"	"Volle Lasermagazine"
"asw_ammo_chainsaw_full"	"Voller Kettensägentreibstoff"
"asw_ammo_pdw_full"	"Volle PDW-Magazine"
"asw_use_icon_format"	"[%s1] %s2"
"asw_hold_use_icon_format"	"[%s1] %s2 halten"
"asw_tesla_ammo"	"Tesla-Falle aktiv"
"asw_turn_sentry"	"Wächter drehen"
"asw_assemble_sentry"	"Wächter aufbauen"
"asw_assembling_sentry"	"Wächter aufstellen"
"asw_disassemble_sentry"	"Halten, um Wächter abzubauen"
"asw_disassembling_sentry"	"Wächter abbauen"
"asw_use_ammo_drop"	"Munition nehmen"
"asw_not_enough_ammo_drop"	"Nicht genügend Munition im Vorrat"
"asw_full_ammo_drop"	"Waffe hat maximale Munition"
"asw_requires_tech"	"Nur Techniker"
"asw_requires_sw"	"Nur Waffenspezialisten"
"asw_requires_nco"	"Nur Offiziere"
"asw_requires_medic"	"Nur Sanitäter"
"asw_cannot_carry_two"	"Du kannst nur einen solchen Gegenstand tragen"
"asw_sarge_only"	"Nur Sarge"
"asw_powerup_requires_bulletammo"	"Benötigt Projektilmunition"
"asw_health_report"	"Gesundheit:\n%s1%"
"asw_hud_low"	"WENIG"
"asw_hud_out_of"	"KEINE"
"asw_hud_ammo"	"MUNITION"
"asw_hud_reload"	"NACHLADEN"
"asw_hud_you_died"	"DU WURDENST IM EINSATZ GETÖTET"
"asw_hud_died"	"%s1 - IM EINSATZ GETÖTET"
"asw_hud_adrenaline"	"%s1 hat Adrenalin aktiviert"
"asw_open"	"Öffnen"
"asw_close"	"Schließen"
"asw_message_log"	"Nachrichtenprotokoll"
"asw_hack_panel"	"Bedienfeld hacken"
"asw_exit_panel"	"Bedienfeld verlassen"
"asw_hack_comp"	"Computer hacken"
"asw_use_panel"	"Bedienfeld benutzen"
"asw_access_terminal"	"Auf das Terminal zugreifen"
"asw_use_terminal"	"Terminal benutzen"
"asw_no_power"	"Kein Strom"
"asw_req_code"	"Benötigt einen Zugangscode"
"asw_override_security"	"Überbrückung"
"asw_give_rifle_ammo"	"Gewehrmagazin abgeben"
"asw_give_autogun_ammo"	"Autogun-Magazin abgeben"
"asw_give_shotgun_ammo"	"Schrotmagazin abgeben"
"asw_give_vindicator_ammo"	"Vindicator-Magazin abgeben"
"asw_give_flamer_ammo"	"Flammenwerfer-Magazin abgeben"
"asw_give_pistol_ammo"	"Pistolenmagazin abgeben"
"asw_give_railgun_ammo"	"Lasermagazin abgeben"
"asw_give_pdw_ammo"	"PDW-Magazin abgeben"
"asw_unknown_ammo_type"	"Unbekannten Munitionstypen abgeben"
"asw_ammo_bag_contents"	"Munitionstasche"
"asw_ammo_title"	"Munition"
"asw_ammo_label"	"Munition:"
"asw_ammo_percent_amount"	"%s1 Prozent"
"asw_kill_objective_format"	"%s1 %s2 %s3/%s4"
"asw_all_survive"	"Marines müssen überleben"
"asw_nuclear_warning"	"WARNUNG"
"asw_nuclear_detonation"	"%s1"
"asw_nuclear_detonationi"	"NUKLEARE EXPLOSION BEVORSTEHEND"
"asw_kill"	"Töten"
"asw_destroy"	"Zerstören"
"asw_drone"	"Drohne"
"asw_drones"	"Drohnen"
"asw_buzzer"	"Schnarre"
"asw_buzzers"	"Schnarren"
"asw_parasite"	"Parasit"
"asw_parasites"	"Parasiten"
"asw_shieldbug"	"Schildkäfer"
"asw_shieldbugs"	"Schildkäfer"
"asw_grub"	"Larve"
"asw_grubs"	"Larven"
"asw_harvester"	"Raffer"
"asw_harvesters"	"Raffer"
"asw_drone_jumper"	"Springerdrohne"
"asw_drone_jumpers"	"Springerdrohnen"
"asw_kill_goo_objective_format"	"Biomasse zerstören %s1/%s2"
"asw_eggs"	"Alien-Eier"
"asw_egg"	"Alien-Ei"
"asw_door_reinforced"	"Tür verstärkt"
"asw_door_fully_reinforced"	"Tür vollständig verstärkt"
"asw_door_sealed"	"Tür verschweißt"
"asw_door_unsealed"	"Verschweißbar"
"asw_door_sealing"	"Tür verschweißen"
"asw_door_reinforcing"	"Tür verstärken"
"asw_door_unsealing"	"Tür aufschweißen"
"asw_achievement_progress"	"Fortschritt"
"asw_medal0"	"Unbekannte Medaille"
"asw_medal1"	"Herz aus Blut"
"asw_medal2"	"Kurze kontrollierte Feuerstöße"
"asw_medal3"	"Schildkäfer ade!"
"asw_medal4"	"Explosionsradius"
"asw_medal5"	"Elektro-geschockt"
"asw_medal6"	"Scharfschütze"
"asw_medal7"	"Unter Beschuss"
"asw_medal8"	"Perfekt"
"asw_medal9"	"Null Sterblichkeit"
"asw_medal10"	"Rührei"
"asw_medal11"	"Schnell und tot"
"asw_medal12"	"Parasitenschläger"
"asw_medal13"	"Feuerwehrmann"
"asw_medal14"	"Haarscharf"
"asw_medal15"	"Blutrausch"
"asw_medal16"	"Rauchende Colts"
"asw_medal17"	"Eiserner Dolch"
"asw_medal18"	"Pyromane"
"asw_medal19"	"Bleib cool"
//"asw_medal20"	"Hybrid Weapons Expert"
"asw_medal20"	"Revolverheld"
"asw_medal21"	"Schadensverstärkt"
"asw_medal22"	"Feuerschutz"
"asw_medal23"	"Eiserner Hammer"
"asw_medal24"	"Schwarmunterdrückung"
"asw_medal25"	"Eisernes Schwert"
"asw_medal26"	"Friedensarzt"
"asw_medal27"	"Glorie in Silber"
"asw_medal28"	"Seuchen Heiland"
"asw_medal29"	"Schützt den Techniker!"
"asw_medal30"	"Sicherheitsexperte"
"asw_medal31"	"Leichter Feldzug"
"asw_medal32"	"Normaler Feldzug"
"asw_medal33"	"Schwerer Feldzug"
"asw_medal34"	"Wahnsinniger Feldzug"
"asw_medal35"	"IAF-Training"
"asw_medal36"	"IAF-Gefechtsauszeichnung"
"asw_medal37"	"IAF-Kampfauszeichnung"
"asw_medal38"	"IAF-Feldzugauszeichnung"
"asw_medal39"	"IAF-Kriegsauszeichnung"
"asw_medal40"	"Profi"
"asw_medal41"	"Erzfeind"
"asw_medal42"	"Vergeltung"
"asw_medal43"	"IAF-Held"
"asw_medal44"	"Speedrun: Landungsbucht"
"asw_medal45"	"Speedrun: Deima Brücke"
"asw_medal46"	"Speedrun: Rydberg Reaktor"
"asw_medal47"	"Speedrun: SynTek Wohnareal"
"asw_medal48"	"Speedrun: Lastenaufzug"
"asw_medal49"	"Speedrun: Abwasseranlage"
"asw_medal50"	"Speedrun: Timor Station"
"asw_medal51"	"Speedrun: Letzte Ölung"
"asw_medal52"	"Herausragend: Landungsbucht"
"asw_medal53"	"Herausragend: Deima Brücke"
"asw_medal54"	"Herausragend: Rydberg Reaktor"
"asw_medal55"	"Herausragend: SynTek Wohnareal"
"asw_medal56"	"Herausragend: Bio-Forschung"
"asw_medal57"	"Herausragend: Abwasseranlage"
"asw_medal58"	"Herausragend: Timor Station"
"asw_medal59"	"Herausragend: Letzte Ölung"
"asw_medaltt0"	"Unbekannt"
"asw_medaltt1"	"Wird einem Marine verliehen, welcher während des\nIAF-Dienstes ernsthaft verwundet oder getötet wurde."
"asw_medaltt2"	"Schließe einen Einsatz ohne Freundbeschuss ab, mit mindestens 4 Soldaten im Einsatz."
"asw_medaltt3"	"Gib einem Schildkäfer den Todesstoß."
"asw_medaltt4"	"Töte 6 Aliens mit einer einzigen Granate."
"asw_medaltt5"	"Stoppe 6 Aliens mit einer einzigen Elektroschock-Granate."
"asw_medaltt6"	"Schließe einen Einsatz mit einer Zielgenauigkeit von mehr als 90% ab."
"asw_medaltt7"	"Rolle unter einem Alien-Projektil hindurch."
"asw_medaltt8"	"Schließe einen Einsatz auf \"Normal\" ab, ohne Schaden zu nehmen."
"asw_medaltt9"	"Schließe einen Einsatz auf \"Normal\" ab, ohne Verluste."
"asw_medaltt10"	"Zerstöre alle Alien-Eier bei einem Einsatz, ohne dass eines schlüpft."
"asw_medaltt11"	"Töte einen Boomer, bevor er sich aufbläht."
"asw_medaltt12"	"Töte einen Parasiten mit einem Nahkampfangriff."
"asw_medaltt13"	"Wird für das Löschen einer großen\nAnzahl von Feuern bei einem einzigen Einsatz verliehen."
"asw_medaltt14"	"Töte 20 Aliens mit Nahkampfangriffen bei einem einzigen Einsatz."
"asw_medaltt15"	"Wird für das Töten einer großen Anzahl\nvon Gegnern in kurzer Zeit verliehen."
"asw_medaltt16"	"Töte 5 Aliens mit explosiven Fässern bei einem einzigen Einsatz."
"asw_medaltt17"	"Wird für das Abschließen eines Einsatzes verliehen, in der\nnur das Sturmgewehr mit einer Genauigkeit größer 90% \nauf dem Schwierigkeitsgrad Schwer verwendet wurde."
"asw_medaltt18"	"Wird für das Abschließen eines Einsatzes verliehen, in der\nnur der Flammenwerfer mit einer Genauigkeit größer 90% \nauf dem Schwierigkeitsgrad Schwer eingesetzt wurde."
"asw_medaltt19"	"Stoppe 6 Aliens mit einer einzigen Frost-Granate."
//"asw_medaltt20"	"Wird für das Abschließen eines Einsatzes verliehen, in der \nnur das Schienegewehr mit einer Genauigkeit größer 90% \nauf dem Schwierigkeitsgrad Schwer verwendet wurde."
"asw_medaltt20"	"Schnelllade 5 mal in Folge erfolgreich deine Waffe."
"asw_medaltt21"	"Töte 15 Aliens mit mindesten 4 Soldaten unter der Wirkung einer Schadensverstärkung bei einem einzigen Einsatz."
"asw_medaltt22"	"Töte 100 Aliens mit Brandminen."
"asw_medaltt23"	"Wird für das Abschließen einer Mission verliehen, in der\nnur die Vindicator mit einer Genauigkeit größer 90%\nauf dem Schwierigkeitsgrad Schwer verwendet wurde."
"asw_medaltt24"	"Wird für das Töten einer großen Anzahl\nvon Gegnern in kurzer Zeit mit der Autogun verliehen."
"asw_medaltt25"	"Wird für das Abschließen einer Mission verliehen, in der\nnur die Autogun mit einer Genauigkeit über 90%\nauf dem Schwierigkeitsgrad Schwer eingesetzt wurde."
"asw_medaltt26"	"Heile 300 Punkte Schaden bei einem Einsatz ohne Aliens mehr als Nahkampfschaden zuzufügen."
"asw_medaltt27"	"Wird für herausragende Arbeit\nbeim Heilen der Kameraden verliehen."
"asw_medaltt28"	"Heile einen befallenen Soldaten."
"asw_medaltt29"	"Beschütze einen Techniker während seinem Hack."
"asw_medaltt30"	"Wird für das Absolvieren\neines schnellen Computer-Hacks verliehen."
"asw_medaltt31"	"Wird für das Absolvieren der Jacob-Kampagne\n auf der Schwierigkeitsstufe \"Leicht\" verliehen."
"asw_medaltt32"	"Wird für das Absolvieren der Jacob-Kampagne\n auf der Schwierigkeitsstufe \"Normal\" verliehen."
"asw_medaltt33"	"Wird für das Absolvieren der Jacob-Kampagne\n auf der Schwierigkeitsstufe \"Schwer\" verliehen."
"asw_medaltt34"	"Wird für das Absolvieren der Jacob-Kampagne\n auf der Schwierigkeitsstufe \"Wahnsinnig\" verliehen."
"asw_medaltt35"	"Wird für das Absolvieren des IAF-Trainings verliehen."
"asw_medaltt36"	"Wird für das Absolvieren von 100 Missionen\nauf dem Schwierigkeitsgrad Normal oder höher verliehen."
"asw_medaltt37"	"Wird für das Absolvieren von 1000 Missionen\nauf dem Schwierigkeitsgrad Normal oder höher verliehen."
"asw_medaltt38"	"Wird für das Absolvieren von 10 Kampagnen\nauf dem Schwierigkeitsgrad Normal oder höher verliehen."
"asw_medaltt39"	"Wird für das Absolvieren von 100 Kampagnen\nauf dem Schwierigkeitsgrad Normal oder höher verliehen."
"asw_medaltt40"	"Wird für das Töten von 5000 Gegnern\nauf dem Schwierigkeitsgrad Normal oder höher verliehen."
"asw_medaltt41"	"Wird für das Töten von 10000 Gegnern\nauf dem Schwierigkeitsgrad Normal oder höher verliehen."
"asw_medaltt42"	"Wird für das Töten von 50000 Gegnern\nauf dem Schwierigkeitsgrad Normal oder höher verliehen."
"asw_medaltt43"	"Wird für das Töten von 100000 Gegnern\nauf dem Schwierigkeitsgrad Normal oder höher verliehen."
"asw_medaltt44"	"Schließe den Einsatz \"Landungsbucht\" innerhalb von 1:25 auf Normal ab, ohne Verluste."
"asw_medaltt44sp"	"Schließe den Einsatz \"Landungsbucht\" innerhalb von 1:25 auf Normal ab, ohne Verluste."
"asw_medaltt45"	"Schließe den Einsatz \"Deima Brücke\" innerhalb von 2:30 auf Normal ab, ohne Verluste."
"asw_medaltt45sp"	"Schließe den Einsatz \"Deima Brücke\" innerhalb von 2:30 auf Normal ab, ohne Verluste."
"asw_medaltt46"	"Schließe den Einsatz \"Rydberg Reaktor\" innerhalb von 3:10 auf Normal ab, ohne Verluste."
"asw_medaltt46sp"	"Schließe den Einsatz \"Rydberg Reaktor\" innerhalb von 3:10 auf Normal ab, ohne Verluste."
"asw_medaltt47"	"Schließe den Einsatz \"SynTek Wohnareal\" innerhalb von 2:30 auf Normal ab, ohne Verluste."
"asw_medaltt47sp"	"Schließe den Einsatz \"SynTek Wohnareal\" innerhalb von 2:30 auf Normal ab, ohne Verluste."
"asw_medaltt48"	"Schließe den Einsatz \"Lastenaufzug\" innerhalb von 2:50 auf Normal ab, ohne Verluste."
"asw_medaltt48sp"	"Schließe den Einsatz \"Lastenaufzug\" innerhalb von 2:50 auf Normal ab, ohne Verluste."
"asw_medaltt49"	"Schließe den Einsatz \"Abwasseranlage\" innerhalb von 1:30 auf Normal ab, ohne Verluste."
"asw_medaltt49sp"	"Schließe den Einsatz \"Abwasseranlage\" innerhalb von 1:30 auf Normal ab, ohne Verluste."
"asw_medaltt50"	"Schließe den Einsatz \"Timor Station\" innerhalb von 4:25 auf Normal ab, ohne Verluste."
"asw_medaltt50sp"	"Schließe den Einsatz \"Timor Station\" innerhalb von 4:25 auf Normal ab, ohne Verluste."
"asw_medaltt51"	"Wird für das Abschließen von Last Rites innerhalb von 6:55\nauf dem Schwierigkeitsgrad Normal oder höher verliehen."
"asw_medaltt51sp"	"Wird für das Abschließen von Last Rites innerhalb von 8:30\nauf dem Schwierigkeitsgrad Normal oder höher verliehen."
"asw_medaltt52"	"Wird für das Absolvieren von Landing Bay in einem Versuch\nim Kampagnen-Modus auf dem Schwierigkeitsgrad Wahnsinnig verliehen."
"asw_medaltt53"	"Wird für das Absolvieren von Deima Surface in einem Versuch\nim Kampagnen-Modus auf dem Schwierigkeitsgrad Wahnsinnig verliehen."
"asw_medaltt54"	"Wird für das Absolvieren von Rydberg Reactor in einem Versuch\nim Kampagnen-Modus auf dem Schwierigkeitsgrad Wahnsinnig verliehen."
"asw_medaltt55"	"Wird für das Absolvieren von SynTek Residential in einem Versuch\nim Kampagnen-Modus auf dem Schwierigkeitsgrad Wahnsinnig verliehen."
"asw_medaltt56"	"Wird für das Absolvieren von Bio-Research in einem Versuch\nim Kampagnen-Modus auf dem Schwierigkeitsgrad Wahnsinnig verliehen."
"asw_medaltt57"	"Wird für das Absolvieren von Sewer Junction in einem Versuch\nim Kampagnen-Modus auf dem Schwierigkeitsgrad Wahnsinnig verliehen."
"asw_medaltt58"	"Wird für das Absolvieren von Timor Station in einem Versuch\nim Kampagnen-Modus auf dem Schwierigkeitsgrad Wahnsinnig verliehen."
"asw_medaltt59"	"Wird für das Absolvieren von Last Rites in einem Versuch\nim Kampagnen-Modus auf dem Schwierigkeitsgrad Wahnsinnig verliehen."
"asw_player_list_player"	"Kommandant"
"asw_player_list_marines"	"Marines"
"asw_player_list_frags"	"Frags"
"asw_player_list_Deaths"	"Tode"
"asw_player_list_ping"	"Ping"
"asw_player_list_kick_check"	"Spieler hinauswerfen."
"asw_player_made_leader"	"%s1 ist der neue Gruppenführer."
"asw_player_kicked"	"%s1 wurde vom Server geworfen."
"asw_player_disco"	"%s1 hat das Spiel verlassen."
"asw_player_list_leader_check"	"Zum Gruppenführer machen"
"asw_player_list_mute_check"	"Stumm schalten"
"asw_kicked_by_vote"	"Durch Spielerabstimmung vom Server geworfen."
"asw_commander_medals"	"Kommandanten-Medaillen:"
"asw_nco_medals"	"Unteroffiziersmedaillen:"
"asw_sw_medals"	"SW-Medaillen:"
"asw_medic_medals"	"Sanitätermedaillen:"
"asw_tech_medals"	"Technikermedaillen:"
"asw_medal_collect_format"	"%s1: %s2"
"asw_sarges_total"	"Sarges Gesamtpunktzahl"
"asw_jaegers_total"	"Jaegers Gesamtpunktzahl"
"asw_wildcats_total"	"Wildcats Gesamtpunktzahl"
"asw_wolfes_total"	"Wolfes Gesamtpunktzahl"
"asw_faiths_total"	"Faiths Gesamtpunktzahl"
"asw_bastilles_total"	"Bastilles Gesamtpunktzahl"
"asw_crashs_total"	"Crashs Gesamtpunktzahl"
"asw_flynns_total"	"Flynns Gesamtpunktzahl"
"asw_vegas_total"	"Vegas' Gesamt"
"asw_medal_collection"	"Medaillensammlung"
"asw_medal_player_collection"	"Medaillensammlung von %s1"
"asw_medal_player_collection_no_s"	"%s1' Medaillensammlung"
"asw_mission_complete"	"MISSION ABGESCHLOSSEN"
"asw_mission_failed"	"MISSION FEHLGESCHLAGEN"
"asw_mission_tab"	"MISSION"
"asw_roster_tab"	"DIENSTPLAN"
"asw_options_tab"	"OPTIONEN"
"asw_stats_tab"	"STATISTIKEN"
"asw_debrief_tab"	"ABSCHLUSSBERICHT"
"asw_medals_tab"	"MEDAILLEN"
"asw_summary"	"ZUSAMMENFASSUNG"
"asw_experience_level"	"Level %s1"
"asw_xp_mission"	"Ziele abgeschlossen"
"asw_xp_kills"	"Abschüsse"
"asw_xp_time"	"Abschlusszeit (Par %s1:%s2)"
"asw_xp_friendly_fire"	"Freundbeschuss"
"asw_xp_damage_taken"	"Schaden eingesteckt"
"asw_xp_healing"	"Schaden geheilt"
"asw_xp_hacking"	"Schnelle Hacks"
"asw_xp_difficulty_scale"	"Schwierigkeitsbonus"
"asw_xp_total"	"ERHALTENE EP"
"asw_next_weapon_unlock"	"Nächste Waffenfreischaltung"
"asw_weapon_unlocked"	"Neue Waffe freigeschaltet!"
"asw_tooltip_weapon_locked"	"WAFFE GESPERRT"
"asw_level_requirement"	"Benötigt Level %s1"
"asw_level_up"	"LEVEL UP!"
"asw_suggest_difficulty"	"Schwierigkeitsgrad ändern?"
"asw_suggest_harder"	"Aufgrund der beeindruckenden Leistung deines Trupps empfiehlt die IAF, auf einen schwereren Schwierigkeitsgrad aufzusteigen. In jeder Missionsnachbesprechung gibt es mehr XP!\n\nErhöhst du den Schwierigkeitsgrad von Normal auf Schwer?"
"asw_suggest_easier"	"Dein Trupp ist vielleicht besser für einen leichteren Schwierigkeitsgrad geeignet. Der Schwarm wird leichter zu töten sein und weniger Schaden anrichten.\n\nSenkst du den Schwierigkeitsgrad von Normal auf Leicht?"
"asw_medals_title"	"MEDAILLEN"
"asw_briefing_no_map"	"ORBITALER SCAN NICHT VERFÜGBAR"
"asw_marines_left"	"Verbleibende Marines: %s1"
"asw_marines_left_one"	"Verbleibende Marines: %s1\nJeweils ein Marine."
"asw_one_marine_each"	"Jeweils ein Marine."
"asw_tech_required"	"Techniker benötigt"
"asw_roster_avail"	"- VERFÜGBAR -"
"asw_no_live_tech"	"Kein lebender Techniker"
"asw_need_tech"	"Diese Mission benötigt mindestens einen Techniker."
"asw_need_equip"	"Diese Mission benötigt mindestens einen %s1."
"asw_need_two_players"	"Diese Mission benötigt mindestens zwei Spieler."
"asw_wants_start"	"%s1 will die Mission beginnen. Bitte 'Bereit' anklicken."
"asw_wants_restart"	"%s1 will die Mission neu starten. Bitte 'Bereit' anklicken."
"asw_wants_continue"	"%s1 will fortfahren. Bitte 'Bereit' anklicken."
"asw_wants_returnmap"	"%s1 will zur Kampagnen-Karte zurückkehren. Bitte 'Bereit' anklicken."
"asw_offline_medals"	"Einzelspieler"
"asw_online_medals"	"Mehrspieler"
"asw_maint_panel"	":: Wartungszugang ::"
"asw_vote_already_in_progress"	"Es kann keine neue Abstimmung gestartet werden, da bereits eine Abstimmung läuft."
"asw_vote_mission_start"	"%s1 hat eine Umfrage gestartet, um die Mission zu ändern: %s2."
"asw_vote_campaign_start"	"%s1 hat eine Umfrage für eine neue Kampagne gestartet: %s2."
"asw_vote_saved_start"	"%s1 hat eine Umfrage gestartet, um einen Spielstand zu laden: %s2."
"asw_press_vote_key"	"Drücke %s1 um abzustimmen."
"asw_mission_doesnt_exist"	"Diese Mission existiert nicht."
"asw_save_doesnt_exist"	"Dieser Spielstand existiert nicht."
"asw_campaign_doesnt_exist"	"Diese Kampagne existiert nicht."
"asw_already_voted"	"Du hast bereits abgestimmt."
"asw_start_vote"	"Abstimmung starten:"
"asw_misson_vote"	"NEUE MISSION"
"asw_campaign_vote"	"MISSION ÄNDERN"
"asw_saved_vote"	"Vorherige Kampagne fortsetzen"
"asw_current_vote"	"Aktuelle Abstimmung:"
"asw_vote_mission_title"	"MISSIONS-ABSTIMMUNG"
"asw_vote_campaign_title"	"KAMPAGNEN-ABSTIMMUNG"
"asw_vote_saved_title"	"Abstimmung um eine gespeicherte Kampagne zu laden"
"asw_vote_yes"	"MIT JA ABSTIMMEN"
"asw_vote_no"	"MIT NEIN ABSTIMMEN"
"asw_vote_yes_key"	"Mit 'Ja' abstimmen"
"asw_vote_no_key"	"Mit 'Nein' abstimmen"
"press_to_vote_yes"	"%s1 drücken, um mit JA abzustimmen"
"press_to_vote_no"	"%s1 drücken, um mit NEIN abzustimmen"
"asw_current_mission_vote"	"Mission ändern: %s1"
"asw_current_campaign_vote"	"Neue Kampagne: %s1"
"asw_current_mission_vote_not_installed"	"Mission ändern: %s1 - SIE HABEN DIESES ADD-ON NICHT"
"asw_current_campaign_vote_not_installed"	"Kampagne ändern: %s1 - SIE HABEN DIESES ADD-ON NICHT"
"asw_current_saved_vote"	"Gespeichertes Spiel laden: %s1"
"asw_vote_passed"	"Abstimmung erfolgreich!"
"asw_vote_failed"	"Abstimmung fehlgeschlagen."
"asw_yes_votes"	"JA-Stimmen: %s1"
"asw_no_votes"	"NEIN-Stimmen: %s1"
"asw_you_voted_no"	"Du hast mit NEIN abgestimmt."
"asw_you_voted_yes"	"Du hast mit JA abgestimmt."
"asw_started_kick_vote"	"%s1 möchte, dass %s2 vom Server geworfen wird."
"asw_started_leader_vote"	"%s1 möchte, dass %s2 der neue Gruppenführer wird."
"asw_time_left"	"Verbleibende Zeit: %s1"
"asw_mission_launch_in"	"Missionsbeginn in: %s1"
"ASW_GameUI_Controller"	"Controller"
"ASW_GameUI_Axes"	"Achsen"
"ASW_GameUI_Buttons"	"Tasten"
"ASW_GameUI_KeyButton"	"(MAUS-)TASTE"
"ASW_GameUI_ControllerButton"	"CONTROLLER-TASTE"
"ASW_GameUI_SetNewButton"	"Taste editieren"
"ASW_GameUI_ClearButton"	"Taste löschen"
"ASW_GameUI_SetNewAxis"	"Achse bearbeiten"
"ASW_GameUI_ClearAxis"	"Achse löschen"
"ASW_GameUI_EnableController"	"Controller aktivieren"
"ASW_GameUI_AimToMovement"	"In Bewegungsrichtung zielen"
"ASW_GameUI_CrossLayout"	"Kreuzförmiges Porträt-Layout"
"ASW_GameUI_AxesAction"	"AKTION"
"ASW_GameUI_ControllerAxis"	"ACHSE"
"ASW_GameUI_MoveForward"	"Bewege dich nach Norden"
"ASW_GameUI_MoveBack"	"Bewege dich nach Süden"
"ASW_GameUI_MoveLeft"	"Bewege dich nach Westen"
"ASW_GameUI_MoveRight"	"Bewege dich nach Osten"
"ASW_GameUI_MoveForwardBack"	"Bewege dich vorwärts/zurück"
"ASW_GameUI_MoveLeftRight"	"Bewege dich nach links/rechts"
"ASW_GameUI_MoveRoll"	"Abrollen"
"ASW_GameUI_AimUpDown"	"Nach vorne / hinten zielen"
"ASW_GameUI_AimLeftRight"	"Links / Rechts zielen"
"ASW_GameUI_AxisX"	"X-Achse"
"ASW_GameUI_AxisY"	"Y-Achse"
"ASW_GameUI_AxisZ"	"Z-Achse"
"ASW_GameUI_AxisR"	"R-Achse"
"ASW_GameUI_AxisU"	"U-Achse"
"ASW_GameUI_AxisV"	"V-Achse"
"ASW_GameUI_NoThanks"	"Nein danke"
"ASW_Marines_Title"	"EINHEIT"
"ASW_Alternates"	"ALTERNATIVEN"
"ASW_GameUI_ControllerRecog"	"Controller erkannt"
"ASW_GameUI_XBCDRecog"	"XBCD-XBox-Gamepad\n\nMöchtest du die standardmäßige Achsen- und Tastenbelegung für diesen Controller einstellen?\n\nHINWEIS: Dieser Controller wird nur unterstützt, wenn due die Hoch/Runter-Achse des \nrechten Analog-Sticks im XBCD-Kontrollzentrum auf RZ-/RZ+ setzt."
"asw_camera_style"	"Kameratyp"
"asw_camera_tilted"	"Geneigt"
"asw_camera_topdown"	"Von oben"
"asw_tracer_style"	"Leuchtspurtyp"
"asw_tracer_none"	"Keine Leuchtspuren"
"asw_tracer_standard"	"Standard-Leuchtspuren"
"asw_tracer_line"	"Linien-Leuchtspuren"
"asw_playerlist"	"Spielerliste / Abstimmungen"
"asw_select_marine_1"	"Marine 1 auswählen"
"asw_select_marine_2"	"Marine 2 auswählen"
"asw_select_marine_3"	"Marine 3 auswählen"
"asw_select_marine_4"	"Marine 4 auswählen"
"asw_select_marine_5"	"Select marine 5"
"asw_select_marine_6"	"Select marine 6"
"asw_select_marine_7"	"Select marine 7"
"asw_select_marine_8"	"Select marine 8"
"asw_next_marine"	"Nächsten Marine auswählen"
"asw_prev_marine"	"Vorherigen Marine auswählen"
"asw_melee_attack"	"Nahkampfangriff"
"asw_activate_extra"	"Zusatzgegenstand (Schweißgerät, Fackeln, etc.) benutzen"
"asw_switch_primary_secondary"	"Waffe wechseln"
"asw_use"	"Benutzen (Schalter, Computer usw.)"
"asw_order_marines_hold"	"Befehl: Position halten"
"asw_order_marines_follow"	"Befehl: Folgen"
"asw_order_specific_marine"	"Bestimmten Marine befehlen"
"asw_order_marine_1_equip"	"Einheitsausrüstung 1 benutzen"
"asw_order_marine_2_equip"	"Einheitsausrüstung 2 benutzen"
"asw_order_marine_3_equip"	"Einheitsausrüstung 3 benutzen"
"asw_order_marine_4_equip"	"Einheitsausrüstung 4 benutzen"
"asw_order_marine_5_equip"	"Use Squad Equipment 5"
"asw_order_marine_6_equip"	"Use Squad Equipment 6"
"asw_order_marine_7_equip"	"Use Squad Equipment 7"
"asw_order_marine_8_equip"	"Use Squad Equipment 8"
"asw_emote_medic"	"Ausruf: Sanitäter!"
"asw_emote_ammo"	"Ausruf: Munition!"
"asw_emote_smile"	"Ausruf: Lächeln"
"asw_emote_watch_out"	"Ausruf: Achtung!"
"asw_emote_anime"	"Ausruf: Anime-Lächeln"
"asw_emote_question"	"Ausruf: Frage"
"asw_drop"	"Aktuelle Waffe fallen lassen"
"asw_select_mission"	"NÄCHSTE MISSION AUSWÄHLEN"
"asw_select_pref_mission"	"BEVORZUGTE MISSION AUSWÄHLEN"
"asw_force_launch"	"Start erzwingen"
"asw_commanders"	"Kommandanten"
"asw_current_location"	"Aktuelle Position:"
"asw_campaign_waiting"	"WARTE"
"asw_threat_level"	"%s1\n\nBedrohungsstufe: %s2"
"asw_campaign_ready"	"OK"
"asw_toggle_console"	"Konsole öffnen"
"asw_ammo_bag_exploded"	"Die Munitionstasche von %s1 überhitzt und explodiert!"
"asw_team_killed"	"%s1 wurde von %s2 getötet."
"asw_player_won_deathmatch"	"%s1 won the round. Congratulations!"
"asw_player_invulnurable"	"%s1 is now invulnurable"
"asw_suicide_male"	"%s1 hat sich selbst getötet."
"asw_suicide_female"	"%s1 hat sich selbst getötet."
"asw_out_of_ammo"	"%s1 hat keine Munition mehr."
// player triggerable speech
"asw_comms"	"Befehle"
"asw_comms_menu"	"Befehlsmenü"
"asw_speech_menu"	"%s1. %s2"
"asw_speech_watchout"	"Pass auf!"
"asw_speech_parasite"	"Parasit!"
"asw_speech_question"	"Was?"
"asw_speech_thanks"	"Danke"
"asw_speech_medic"	"Sanitäter!"
"asw_speech_needammo"	"Brauche Munition!"
"asw_speech_stim"	"Adrenalin! Jetzt!"
"asw_speech_positioning"	"Gehe in Position..."
"asw_speech_doors"	"Türen..."
"asw_speech_more"	"Mehr..."
"asw_speech_point"	"Gehe voraus"
"asw_speech_rear"	"Nachhut"
"asw_speech_holding"	"Halte Position"
"asw_speech_north"	"Gebe Deckung in Richtung Norden"
"asw_speech_south"	"Gebe Deckung in Richtung Süden"
"asw_speech_east"	"Gebe Deckung in Richtung Osten"
"asw_speech_west"	"Gebe Deckung in Richtung Westen"
"asw_speech_hold"	"Position halten"
"asw_speech_go"	"Mir folgen"
"asw_speech_back"	"Zurück..."
"asw_speech_rcut"	"Aufschneiden anfordern"
"asw_speech_rseal"	"Versiegelung anfordern"
"asw_speech_rshoot"	"Beschuss anfordern"
"asw_speech_cut"	"Tür aufschneiden"
"asw_speech_seal"	"Tür versiegeln"
"asw_speech_medkit"	"Medkit."
"asw_speech_ammo"	"Munition."
"asw_speech_careful"	"Vorsicht"
"asw_speech_ready"	"Bereit?"
"asw_speech_smile"	"*lächeln*"
"asw_speech_zing"	"Zisch!"
// sarge speech
"asw_speech_signs"	"Anzeichen von Verseuchung"
"asw_speech_form"	"Einheit, formiert euch"
"asw_speech_positions"	"Marines, in Position"
"asw_speech_mouth"	"Pass auf was du sagst, Marine"
"asw_speech_secure_that"	"Du sicherst den Scheiß"
"asw_speech_drink"	"Ich brauche einen Drink"
"asw_speech_looks_good"	"Sieht gut aus"
"asw_speech_stay_sharps"	"Augen offenhalten"
"asw_speech_love_job"	"Ich liebe diesen Job"
"asw_speech_fine_day"	"Noch ein toller Tag in der IAF"
"asw_speech_picnic"	"Kein Picknick"
"asw_speech_spacing"	"Achtet auf euren Abstand Team"
"asw_speech_so_far"	"So weit, so gut"
"asw_speech_holy"	"Verdammte Scheiße!"
"asw_speech_eat"	"Friss das!"
"asw_speech_paychecks"	"Zeit sich diese Gehaltschecks zu verdienen"
"asw_speech_corners"	"Auf die Ecken achten!"
"asw_speech_squads"	"In Teams fortfahren"
"asw_speech_book"	"Lasst uns das genau nach Vorschrift machen"
"asw_speech_like_hear"	"Das wollte ich hören"
"asw_speech_damn_fine"	"Verdammte gute Arbeit, Marine"
"asw_speech_pull"	"Wir sollten uns zurückziehen, das nochmal überdenken"
"asw_speech_tough"	"Das ist hart"
"asw_speech_got_backs"	"Ich geb' dir Deckung"
// jaeger speech
"asw_speech_never_thought"	"Hätte niemals gedacht, dass es so enden würde."
"asw_speech_bad_feeling"	"Ich hab' ein schlechtes Gefühl bei diesem Ort."
"asw_speech_no_trouble"	"Behebe Käfer-Problem"
"asw_speech_run_smokes"	"Keine Rauchgranaten mehr"
"asw_speech_set_fire"	"Zündet die Kolonie an"
"asw_speech_sharp_prisoners"	"Aufpassen, Leute"
"asw_speech_another_day"	"Nur ein weiterer Tag im Korps"
"asw_speech_vacation"	"Ich brauche Urlaub"
"asw_speech_hungry"	"Das hier macht einen Marine hungrig"
"asw_speech_rock_roll"	"Rock and Roll!"
"asw_speech_want_some"	"Du willst auch was?"
"asw_speech_spirit"	"Genau so!"
"asw_speech_breathing"	"Atmet ihr auch noch?"
// wildcat speech
"asw_speech_t75"	"T75 Sprengstoff"
"asw_speech_party"	"Lasst uns die Party beginnen"
"asw_speech_peace"	"Frieden durch überlegene Feuerkraft"
"asw_speech_dares_wins"	"Wer wagt, gewinnt"
"asw_speech_cooling_heels"	"Sollten wir nicht Käfer kaltmachen?"
"asw_speech_anytime_anywhere"	"Jederzeit, überall"
"asw_speech_theyll_pay"	"Sie werden dafür bezahlen"
"asw_speech_hell_out"	"Es wird Zeit hier zu verschwinden"
"asw_speech_payback"	"Rache ist süß"
"asw_speech_nice_job"	"Gute Arbeit"
"asw_speech_meow"	"Miau"
"asw_speech_hell_yeah"	"Jawoll, verdammt!"
"asw_speech_taking_long"	"Was dauert es so lange?"
"asw_speech_christ_man"	"Herrgott nochmal"
// wolfe speech
"asw_speech_lock_load"	"Geladen und entsichert"
"asw_speech_time_bleed"	"Hab' keine Zeit zu bluten"
"asw_speech_all_over"	"Schlag sie wo es am meisten weh tut"
"asw_speech_alright"	"Haha, okay!"
"asw_speech_smell_bugs"	"Ich rieche Käfer"
"asw_speech_collateral"	"Kollateralschaden"
"asw_speech_scores_settle"	"Ich habe noch eine Rechnung offen"
"asw_speech_good_bug"	"Nur ein toter Käfer ist ein guter Käfer"
"asw_speech_dont_hurt"	"Wenn man sie nicht trifft, tut es ihnen auch nicht weh"
"asw_speech_one_way"	"Nur ein Weg um das zu lösen"
"asw_speech_more_fun"	"Es wird spaßiger im Minutentakt"
"asw_speech_wait_day"	"Lass mich nicht den ganzen Tag warten"
"asw_speech_nice_shootin"	"Gut geschossen!"
"asw_speech_save_life"	"Du hast mir das Leben gerettet"
"asw_speech_challenge"	"Hört sich nach einer Herausforderung an"
"asw_speech_trick"	"Ist das eine Fangfrage?"
"asw_speech_kidding"	"Willst du mich verarschen?"
// faith speech
"asw_speech_what_need"	"Was brauchst du?"
"asw_speech_be_careful"	"Lasst uns vorsichtig sein, ok?!"
"asw_speech_excellent"	"Exzellent"
"asw_speech_absolutely"	"Absolut"
"asw_speech_too_quiet"	"Es ist viel zu ruhig"
"asw_speech_nightmare"	"Das hier ist wie ein schrecklicher Albtraum"
"asw_speech_pull_through"	"Ich hoffe wir schaffen das"
"asw_speech_isnt_secure"	"Dieser Ort ist nicht sicher"
"asw_speech_down_here"	"Ich mag's hier unten nicht"
"asw_speech_wait_hear"	"Wartet! Ich höre etwas"
"asw_speech_kill_you"	"Ich bring euch alle um!"
"asw_speech_oom"	"Hab' keine Erste-Hilfe-Kästen mehr"
"asw_speech_love_harm"	"Du scheinst es zu lieben dem Unheil in die Arme zu laufen"
// bastille speech
"asw_speech_good_thinking"	"Gute Idee"
"asw_speech_immediatement"	"Umgehend"
"asw_speech_careful_anywhere"	"Vorsicht, sie könnten überall sein"
"asw_speech_stim_packs"	"Adrenalin macht jetzt nicht so süchtig"
"asw_speech_send_hell"	"Jagt diese Bastarde direkt in die Hölle"
"asw_speech_how_many"	"Wie viele von diesen Viechern gibt's eigentlich?"
"asw_speech_stay_sharp"	"Haltet die Augen offen, mes ami"
"asw_speech_what_was"	"Was war das?"
"asw_speech_hearing_things"	"Toll, jetzt höre ich schon Dinge die nicht da sind"
"asw_speech_exit"	"Zeit abzuhauen"
"asw_speech_alien_scum"	"Friss das, Alienabschaum!"
"asw_speech_should_dead"	"Du solltest tot sein, aber du bist es nicht"
"asw_speech_youll_live"	"Du wirst es wahrscheinlich überleben"
"asw_speech_should_help"	"Das sollte helfen"
"asw_speech_kill_ami"	"Guter Schuß, mon ami"
"asw_speech_annoying"	"Du fängst an zu nerven"
"asw_speech_closer"	"Sie kommen näher!"
"asw_speech_breakdown"	"Nervenzusammenbruch"
"asw_speech_why_close"	"Warum kommst du mir so nah?"
"asw_speech_saving"	"Ich bewahre sie auf, für den Fall, dass du wirklich verletzt wirst"
"asw_speech_off_mission"	"Bei der nächsten Mission bist du nicht dabei"
"asw_speech_alright_say_so"	"Okay, wenn du meinst"
// crash speech
"asw_speech_ready_get"	"Ich bin für alles bereit"
"asw_speech_get_fuck"	"Wir sollten schleunigst von hier verschwinden!"
"asw_speech_got_skills"	"Ich hab's drauf"
"asw_speech_shoulda_stolen"	"Ich hätte mehr Geld stehlen sollen um diesen Scheiß hier auszugleichen"
"asw_speech_guys_lucky"	"Ihr könnt froh darüber sein, dass ich hier bin"
"asw_speech_like_to_see"	"Oh ja! Sowas seh' ich gerne"
"asw_speech_want_some_of"	"Willst du auch was abhaben?"
"asw_speech_time_magic"	"Zeit, dass ich mal meine Tricks zeige"
"asw_speech_got_back"	"Du gibst mir Deckung, oder?"
"asw_speech_who_man"	"Oh yeah, wer hat's drauf?"
"asw_speech_smooth"	"Ganz geschmeidig"
"asw_speech_cant_stand"	"Ich halte es hier nicht mehr lange aus"
"asw_speech_anyone_idea"	"Hat einer von euch 'ne Ahnung, was wir hier überhaupt machen?"
"asw_speech_no_problem"	"Kein Problem"
"asw_speech_place_action"	"Wow, hier war wohl einiges los"
// flynn speech
"asw_speech_got_job"	"Hast du was für mich zu tun?"
"asw_speech_bad_idea"	"Das war eine schlechte Idee"
"asw_speech_calm_storm"	"Ah, die Ruhe vor dem Sturm"
"asw_speech_surrounded"	"Ich glaube wir sind umzingelt"
"asw_speech_grim"	"Sieht nicht allzu gut aus"
"asw_speech_places_hide"	"Hier unten gibt's viele Verstecke"
"asw_speech_followed"	"Bilde ich mir das ein oder werden wir verfolgt?"
"asw_speech_company"	"Wir haben Besuch!"
"asw_speech_corp_net"	"Es geht doch nichts über das Einbrechen in ein Firmennetzwerk"
"asw_speech_nice_work"	"Gute Arbeit"
"asw_speech_looks_clear"	"Sieht ruhig aus"
"asw_speech_dont_worry"	"Sorg dich nicht um mich"
// vegas speech
"asw_speech_little_game"	"Willst du ein Spielchen mit mir spielen?"
"asw_speech_ace_sleeve"	"Ich hab' immer noch ein Ass im Ärmel"
"asw_speech_on_it"	"Bin dran"
"asw_speech_4_to_1"	"Chancen von 4 zu 1? Find' ich gar nicht mal so schlecht"
"asw_speech_deck_cards"	"Hat einer von euch ein Kartenspiel dabei?"
"asw_speech_tequila"	"Wer hat Lust auf ein bisschen Tequila?"
"asw_speech_worst_come"	"Ich denke, das Schlimmste kommt noch"
"asw_speech_roll_dice"	"Zeit die Würfel zu werfen"
"asw_speech_sweet_tequila"	"Mein liebster Tequila, ich bin auf dem Weg zu dir!"
"asw_speech_madre_dios"	"Madre de dios!"
"asw_speech_play_rough"	"Oh, du willst es auf die harte Tour?"
"asw_speech_muchachos"	"Adios muchachos"
"asw_speech_fuck_with_me"	"Willst du dich mit mir anlegen?"
"asw_speech_finally_time"	"Endlich etwas, dass meine Zeit wert ist"
"asw_speech_back_ok"	"Halte meinen Rücken frei, ok?"
"asw_speech_too_easy"	"Zu einfach"
"asw_speech_job_amigo"	"Gute Arbeit, Amigo"
"asw_speech_impressive"	"Beeindruckend!"
"asw_speech_nice_one_amigo"	"Gut gemacht, Amigo"
"asw_speech_clock_ticking"	"Die Zeit läuft, Amigo"
"asw_speech_lady_luck"	"Das Glück ist auf meiner Seite"
"asw_speech_fortune_fav"	"Das Schicksal bevorzugt heute Vegas"
"asw_speech_could_tequila"	"Jetzt wäre ein guter Zeitpunkt für etwas Tequila..."
"asw_speech_ahh_man"	"Ach man, ich hätte in Culiacan bleiben sollen"
"asw_speech_crazy_ones"	"Warum krieg' ich immer die Verrückten ab?"
"asw_cain_mail_0"	"Übertragung von: SynTek Forschungsstation 7"
"asw_cain_mail_1"	"Datum: 20.12.52"
"asw_cain_mail_2"	"."
"asw_cain_mail_3"	"Lt. Cain,"
"asw_cain_mail_4"	"Wir haben Ihre Nachricht erhalten und wir werden die nötigen Vorsichtsmaßnahmen vornehmen."
"asw_cain_mail_5"	"Wir haben einen Frachter, der auf dem Weg zu Vereon XII ist, um Lieferung 4903877 aufzunehmen."
"asw_cain_mail_6"	"Ungefähre Ankunftszeit: 14 Tage"
"asw_cain_mail_7"	"Erwarten Sie noch dieses Jahr eine Beförderung."
"asw_tutorial_message_1"	"%s1 %s2 %s3 %s4 um den Marine zu bewegen"
"asw_tutorial_message_2"	"%s1 um Gegenstände aufzuheben"
"asw_tutorial_message_3"	"Maus zum Zielen\n%s1 zum Feuern"
"asw_tutorial_message_4"	"%s1 Bedienfeld benutzen"
"asw_tutorial_message_5"	"%s1 /\n%s2 um die Waffe zu wechseln"
"asw_tutorial_message_6"	"%s1 zum Feuern"
"asw_tutorial_message_7"	"%s1 für Nahkampfangriff"
"asw_tutorial_message_8"	"%s1 um Tür zu versiegeln\n%s2 um Tür aufzuschneiden"
//"asw_tutorial_message_9"	"1,2,3,4 to select marine\n%s1 orders marine to follow\n%s2 orders marine to guard a spot\n%s3 to order marine under the mouse cursor"
"asw_tutorial_message_9"	"1 - Ersten Marine auswählen\n2 - Zweiten Marine auswählen"
"asw_tutorial_message_10"	"1 - Ersten Marine auswählen\n2 - Zweiten Marine auswählen\n3 - Dritten Marine auswählen"
"asw_tutorial_message_11"	"1,2 um Marine auszuwählen\n%s1 um Bedienfeld zu benutzen"
"asw_tutorial_message_12"	"%s1 um Fackeln aufzuheben\n%s2 zum Werfen einer Fackel"
"asw_tutorial_message_13"	"%s1 zum Aufheben\n%s1/%s2 um die Waffe zu wechseln"
"asw_tutorial_message_14"	"%s1 um Munition aufzuheben\n%s2 zum Nachladen"
"asw_tutorial_message_15"	"%s1 um Bedienfeld zu benutzen"
"asw_tutorial_message_16"	"%s1 um Terminal zu benutzen"
"asw_tutorial_message_17"	"%s1 um Folgen zu befehlen\n%s2 um Position Halten zu befehlen\n%s3 um einen bestimmten Marine an eine Position zu befehligen"
"asw_instructor_infestation_death"	"Heilen ist die einzige Möglichkeit eine Infizierung zu überleben"
"asw_instructor_switch_marine"	"Marine steuern"
"asw_instructor_select_med_satchel"	"Erste-Hilfe-Kasten auswählen"
"asw_instructor_cure_infestation_other"	"Heilen um Verseuchung zu kurieren"
"asw_instructor_cure_infestation"	"Heilen um Verseuchung zu überleben"
"asw_instructor_request_cure"	"Rufe einen Sanitäter, um den Befall zu überleben"
"asw_instructor_select_extinguisher"	"Feuerlöscher auswählen"
"asw_instructor_extinguish"	"Löschen"
"asw_instructor_watch_scanner"	"Bewegungsmelder beobachten"
"asw_instructor_friendly_fire"	"Verletze keine Teamkameraden"
"asw_instructor_hack_button_area"	"Bedienfeld entsperren"
"asw_instructor_use_button_area"	"Bedienfeld aktivieren"
"asw_instructor_destroy_door"	"Tür zerstören"
"asw_instructor_destroy_door_secondary"	"Sekundäre Feuerschutztür"
"asw_instructor_weld_door"	"Tür verschweißen"
"asw_instructor_unweld_door"	"Tür aufschweißen"
"asw_instructor_heal"	"Teamkameraden heilen"
"asw_instructor_heal_self"	"Selbst heilen"
"asw_instructor_request_heal"	"Sanitäter rufen"
"asw_instructor_clip_usage"	"%s1 Munition des vorherigen Magazins verloren"
"asw_instructor_use_offhand"	"Zusatz-Gegenstand benutzen"
"asw_instructor_use_offhand_health"	"Aus dem Stegreif selbst heilen"
"asw_instructor_switch_weapon"	"Waffe auswählen"
"asw_instructor_place_sentry"	"Wächter platzieren"
"asw_instructor_build_sentry"	"Wächter aufbauen"
"asw_instructor_rotate_sentry"	"Wächter ausrichten"
"asw_instructor_dismantle_sentry"	"Halten zum Abbauen"
"asw_instructor_laser_boulder"	"Mit dem Bergbau-Laser zerstören"
"asw_instructor_burn_biomass"	"Biomasse verbrennen"
"asw_instructor_command_marine"	"Marine kommandieren"
"asw_instructor_command_marine_follow"	"Alle Marines Folgen"
"asw_instructor_command_marine_hold"	"Alle Marines Position Halten"
"asw_instructor_pick_up_item"	"Aufheben"
"asw_instructor_swap_item"	"Tauschen"
"asw_instructor_get_item"	"%s1 aufnehmen"
"asw_instructor_swap_for_item"	"Gegen %s1 eintauschen"
"asw_instructor_need_hacker_button_area"	"Techniker benötigt"
"asw_instructor_select_alt_fire"	"Wählen eine Waffe mit Sekundärmunition"
"asw_instructor_alt_fire"	"Sekundärfeuer"
"asw_instructor_give_bag_ammo"	"Muniton abgeben"
"asw_instructor_give_satchel_ammo"	"Munition für %s1 hinlegen"
"asw_instructor_yourself"	"Sie"
"asw_instructor_give_spare_weapon"	"Unbenutzte Waffe abgeben"
"asw_instructor_kick_object"	"Nahkampf"
"asw_instructor_shoot_barrel"	"Beschieße die Explosivfässer"
"asw_instructor_manual_reload"	"Manuelles Nachladen"
"asw_instructor_view_map"	"Vollständige Karte anzeigen"
"asw_instructor_toggle_orders"	"Halten um Ausrüstungsordnung umzuschalten"
"asw_instructor_radial_emote"	"Halten für Ausdrucksmenü"
"asw_instructor_mic_chat"	"Zum Mikrofon-Chat gedrückt halten"
"asw_instructor_draw"	"Zeichne zum Planen auf die Karte"
"asw_instructor_roll"	"Abrollen um Projektilen auszuweichen"
"asw_instructor_walk"	"Halten um zu gehen"
"asw_instructor_movement"	"Marine bewegen"
"asw_fail_advice_teamwork"	"Koordiniere die Bewegungen und Schusslinien deiner Einheit."
"asw_fail_advice_loadout"	"Koordiniere die Ausrüstung deiner Einheit."
"asw_fail_advice_routes"	"Plane die Routen deiner Einheit und bedenke Alternativen."
"asw_fail_advice_low_ammo"	"Behalte den Munitionsverbrauch deiner Einheit im Auge."
"asw_fail_advice_infested_lots"	"Spare Medizin, indem du Parasitenbefall vermeidest."
"asw_fail_advice_infested"	"Verwende deine medizinische Ausstattung, um befallene Teamkameraden zu retten und zu heilen."
"asw_fail_advice_swarmed"	"Bau defensive Selbstschussanlagen um große Schwärme zu bekämpfen."
"asw_fail_advice_friendly_fire"	"Vermeide Freundbeschuss."
"asw_fail_advice_hacker_damaged"	"Beschütze einen Techniker während seinem Hack."
"asw_fail_advice_wasted_heals"	"Das Verwenden von Heilungsgegenständen bei guter Gesundheit kann Verschwendung sein."
"asw_fail_advice_ignored_healing"	"Benutze Heilgegenstände, um deine Einheit gesund zu halten."
"asw_fail_advice_ignored_adrenaline"	"Benutze Adrenalin, um schwere Kämpfe leichter zu machen."
"asw_fail_advice_ignored_secondary"	"Sekundärfeuer können Gegnergruppen ausschalten."
"asw_fail_advice_ignored_welder"	"Verschweiße Türen, um Gegnern den Weg zu versperren."
"asw_fail_advice_ignored_lighting"	"Benutze Fackeln, um Gegner im Dunklen sichtbar zu machen."
"asw_fail_advice_slow_progression"	"Es kommen weitere Gegner, wenn deine Einheit nur langsam vorankommt."
"asw_fail_advice_shield_bug"	"Der Schildkäfer kann Frontalangriffe blockieren."
"asw_fail_advice_died_alone"	"Halte die Formation deiner Einheit zusammen, um zu verhindern, dass ihr überrannt werdet."
"asw_fail_advice_no_medics"	"Nimm einen Sanitäter mit, um deine Einheit gesund zu halten."
"asw_stats_player_name"	"%s1 %s2 EP: %s3"
"asw_stats_player_status_leader"	"(Gruppenführer)"
"asw_stats_player_status_ready"	"(bereit)"
"asw_stats_kills"	"Abschüsse"
"asw_stats_kills_desc"	"Anzahl der getöteten Gegner"
"asw_stats_accuracy"	"Genauigkeit"
"asw_stats_accuracy_desc"	"% der vom Kommandanten verschossenen Munition, die getroffen hat"
"asw_stats_ff"	"Freundbeschuss"
"asw_stats_ff_desc"	"Schaden, welcher Teamkameraden zugefügt wurde"
"asw_stats_damage"	"Schaden eingesteckt"
"asw_stats_damage_desc"	"Schaden, die der Marine in dem Einsatz genommen hat"
"asw_stats_shots"	"Schüsse abgegeben"
"asw_stats_shots_desc"	"Von diesem Marine verschossene Munition"
"asw_stats_ammo"	"Munition"
"asw_stats_ammo_desc"	"Munition, die der Marine hat"
"asw_stats_time"	"Benötigte Zeit"
"asw_stats_time_desc"	"In diesem Einsatz benötigte Zeit des Teams"
"asw_stats_tkills"	"Kills insgesamt"
"asw_stats_tkills_desc"	"Anzahl an durch das Team getöteten Gegnern"
"asw_stats_health"	"Gesundheit"
"asw_stats_health_desc"	"Lebenspunkte der Marines"
"asw_stats_healed"	"Geheilte Lebenspunkte"
"asw_stats_healed_desc"	"Lebenspunkte die durch Sanitäter geheilt wurden"
"asw_stats_burned"	"Brandabschüsse"
"asw_stats_burned_desc"	"Anzahl an durch Brandminen getöteten Gegnern"
"asw_stats_fasth"	"Schnelle Hackvorgänge"
"asw_stats_fasth_desc"	"Anzahl an schnellen Hacks / Computer-Hacks"
"asw_stats_skillpoints"	"Fähigkeitspunkte"
"asw_stats_skillpoints_desc"	"Fähigkeitspunkte, die durch diese Mission verdient werden. Es werden weniger Fähigkeitspunkte\nverliehen, wenn der Marine übermäßig Schaden nimmt\n oder andere Marines verletzt.\n\nZusätzliche Fähigkeitspunkte werden für das Erlangen bestimmter\nMedallien vergeben."
"asw_wounded"	"VERWUNDET"
"asw_wounded_tt"	"Der Marine ist verwundet nachdem er erheblichen Schaden in\nder vorherigen Mission erlitten hat. Verwundete Marines können ausgewählt werden,\naber sie werden nur die Hälfte ihrer Gesundheit in dieser Mission zur Verfügung haben.\nDie Wunden werden nach dem erfolgreichen Abschluss der nächsten Mission geheilt."
"asw_kia"	"GEFALLEN"
"asw_kia_tt"	"Im Einsatz gefallen."
"asw_reserved"	"RESERVIERT"
"asw_reserved_tt"	"Marine ist zurzeit für den vorherigen Kommandanten reserviert."
"asw_wdesc_rifle"	"Die 22A3-1 ist die standardmäßig an IAF-Marines ausgegebene Gefechtswaffe. Durch die hohe Feuerrate, die mit Sprengstoff beladenen Hochgeschwindigkeitspatronen und einem unterbauten Granatwerfer, bietet diese Waffe eine bedeutende Flexibilität im Einsatz, mit der Möglichkeit sowohl kleine als auch große Ziele auszuschalten. Die Standard-Magazingröße fasst 98 Patronen."
"asw_wdesc_prifle"	"Die 22A7-Z ist ein Prototyp des Standard 22A3-Sturmgewehrs, welche für den Einsatz in städtischen Umgebungen entworfen wurde und auf die Kontrolle von Menschenmengen sowie Notfälle in der Nähe ziviler Ziele spezialisiert ist. Immer noch in der Test-Phase befindlich, wurden etliche Modelle an die IAF zur Beurteilung weitergegeben. Die A7-Z ist mit einer Zielhilfe und einer Reihe von Betäubungsgranaten ausgerüstet. Da eine komplizierten Feinabstimmung der Zielhilfe dieses Prototyps nötig ist, kann dieses Gewehr nur von Marines mit technischer Ausbildung verwendet werden."
"asw_wdesc_sniper_rifle"	"Das AVK-36-Scharfschützengewehr ist eine halbautomatische Repetierbüchse, die mit ihren 7.62x51mm-Patronen dazu in der Lage ist, eine Schwarmdrohne mit nur einem Schuss zu zerstören. Das AVK-36 ist eine modifizierte Version des klassischen AVK-32, angepasst an die Kampfanzüge der Marines und dazu bestimmt, auch in Bewegung zu feuern."
"asw_wdesc_autogun"	"Die S23A SynTek Autogun zählt zu den modernsten Sturmgewehren die zur Zeit verfügbar sind. Mit einem ausgeklügelten Zielverfolgungssystem und einer leistungsstarken Induktionskammer zum Aufbau eines elektromagnetischen Feldes, kann diese Waffe feindliche Ziele identifizieren und automatisch die Flugbahn der Kugeln beim Verlassen des Laufes verändern, um sicherzustellen, dass diese ihr Ziel treffen. Die Autogun besitzt eine erhebliche Mannstoppwirkung und kann eingesetzt werden um eine große Anzahl ankommender Ziele zu verdrängen. Eine Ausbildung zum Waffenspezialisten wird benötigt."
"asw_wdesc_minigun"	"Die IAF-Minigun hat eine sehr hohe Feuerrate und eine weite Streuung, ideal um eine größere Gruppen von feindlichen Zielen auszuschalten. Diese Waffe braucht einen Moment, um den Lauf auf die geforderte Drehzahl zu bringen. Die Alt-Feuer-Taste bringt den Lauf in Drehung ohne dabei zu feuern."
"asw_wdesc_bait"	"Ein großer Klumpen synthetisches Fleisch getränkt in Schwarmpheromonen. Wird nahen Schwarm vorübergehend ablenken."
"asw_wdesc_shotgun"	"Eine traditionelle, halbautomatische Schrotflinte, welche Kaliber 12-Geschosse abfeuert. Beliebt aufgrund ihres starken, besonders im Nahbereich effektiven, Streufeuers. Bis zu vier Patronen können geladen werden."
"asw_wdesc_vindicator"	"Die M42 Vindicator ist eine durch Druckluft gestützte Schrotflinte mit einem dualen Magazin-Selektionssystem. Die IAF-Standard-Munition wird mit Kaliber-12-Patronen im ersten Magazin unterstützt und etliche Brandgranaten in einem weiteren. Die Vindicator wird nur an Offiziere ausgegeben."
"asw_wdesc_pdw"	"Die K80 ist eine leichte, vollautomatische Maschinenpistole. Sie wird als Paar abgegeben und wurde entwickelt, um über eine kurze Zeitspanne großen Schaden anzurichten. Da durch die hohe Feuerrate die Munition schnell aufgebraucht ist, empfiehlt das IAF-Kommando sie als Sekundärwaffe einzusetzen."
"asw_wdesc_grenades"	"Ein Satz hochexplosiver Streugranaten. Granaten mit höherer Streuwirkung werden an Marines mit besseren Sprengstofffähigkeiten verteilt."
"asw_wdesc_freeze_grenades"	"Ein Satz an hochexplosiven Flüssigstickstoffkanistern. Jeder Kanister friert alle Ziele im Explosionsradius vorübergehend ein und macht sie somit sehr verwundbar gegenüber Stößen."
"asw_wdesc_grenade_launcher"	"Basierend auf dem umfangreichen IAF Mortar Emplacement Design feuert dieser tragbare Werfer hochexplosive Granaten auf Feinde in der Nähe. Geh mit äußerster Vorsicht vor, wenn du dieses Gerät in der Nähe von verbündeten Einheiten benutzt. Hohe Gefahrenstufe, Marines."
"asw_wdesc_night_vision"	"Wärmebasierter Bildverstärker mit niedrigem Signal-Rausch-Verhältnis und selbstaufladendem Akku. Das MNV34 bietet eine hohe Auflösung mit einem breitem dynamischem Luminanzbereich, wodurch es sich für alle Lichtverhältnisse eignet. Der leichte Standard-Akku erlaubt eine Verwendung über 10 Sekunden."
"asw_wdesc_flamer"	"Die M868 benutzt unter Hochdruck stehenden Napalm-basierten Treibstoff und kann dadurch eine weite Fläche abdecken. Alle Ziele die von den Flammen getroffen werden brennen für eine längere Zeit. Vor allem im Marsch ist es wichtig sicherzustellen, dass sich kein Teammitglied im Weg der Flammen befindet."
"asw_wdesc_extinguisher"	"Gefüllt mit einem Mehrzweck-Flammenlöschmittel, kann dieser Gegenstand zum Löschen jeglicher Art von Feuer, das im Gebiet vorkommt, benutzt werden."
"asw_wdesc_welder"	"Das von der IAF ausgegebene Handschweißgerät nutzt heißes, ionisiertes Plasma, um einen Lichtbogen zum effektiven Schneiden oder Schweißen zu erzeugen, je nach Bedürfnis des Nutzers. Hauptsächlich im Feld genutzt, um Türen aufzubrennen oder zu versiegeln, bietet es den IAF-Marines einen taktischen Vorteil."
"asw_wdesc_flashlight"	"Ein heller, selbstaufladender Taschenlampenaufsatz mit mehreren Birnen für gezielte Beleuchtung in Momenten schwacher Sicht."
"asw_wdesc_mines"	"Ein fünfteiliger Satz M478-Annäherungsbrandminen gehört zur Standardausrüstung eines jeden Offiziers. Diese Minen werden im Einsatzgebiet platziert und kalibriert und detonieren nach ihrer Aktivierung, sobald sich ein Lebewesen nähert, das den Zielbestimmungen entspricht. Bei der Detonation wird hochentzündliches Napalm auf beiden Seiten der Mine geradlinig freigesetzt, das das Opfer tötet sowie das Gebiet gegen weitere Feinde absichert."
"asw_wdesc_laser_mines"	"Ein Paket von anbringbaren Haftminen. Die Detonation wird bei Unterbrechen des Laserstrahls durch eine feindliche Einheit ausgelöst. Sprengstofferfahrene Marines können mehrere Minen mit einem einzigen Wurf platzieren."
"asw_wdesc_electrified_armor"	"Die Aktivierung der Hochspannungsfunktion dieser Marine-Rüstung betäubt jeden Angreifer der in Kontakt mit dem Anzug gerät, reduziert gegnerischen Nahkampfschaden und vertreibt infizierende Parasiten."
"asw_wdesc_normal_armor"	"Das Tragen zusätzlicher Graphen-Rüstungsplatten verbessert den Schutz gegenüber allen Arten von Angriffen."
"asw_wdesc_fist"	"Die Powerfaust ist ein IAF entwickelter Kampfanzugsaufsatz, der den Schaden aller Nahkampfattacken von der Faust bis zum Fuß erhöht."
"asw_wdesc_blink"	"Ein Gerät im Entwicklungsstadium, welches den Nutzer zu einem nahe gelegenen Zielort teleportiert. Die freigesetzte Energie an den Ein- und Ausstiegspunkten betäubt Gegner im näheren Umkreis. Entwickelt von der Enigma Research Group, befindet sich dieses Gerät im Moment im Feldtest bei der IAF."
"asw_wdesc_jump_jet"	"Ein einsatzlimiterter Rucksackaufsatz, der den Marine in die Luft katapultiert, ihm erlaubt kurze Distanzen zurückzulegen und einen starken Aufprall zu liefern. Von Premier Propulsion Research hergestellt."
"asw_wdesc_t75"	"Abrisssprengstoff. Halte nach dem Scharfstellen den Sicherheitsabstand ein."
"asw_wdesc_damage_amp"	"Die Waffen aller Marines innerhalb des Leuchtradius sind elektromagnetisch optimiert um Schüsse mit erhöhter Stärke abzufeuern."
"asw_wdesc_hornet_barrage"	"Setzt eine Salve an explosiven Zielerfassungs-Raketen frei. Marines mit höherer Ausbildung sind autorisiert mehr Raketen pro Cluster zu tragen."
"asw_wdesc_smart_bomb"	"Mithilfe eines patentierten Multiple Threat Denial-Zielerfassungssystems ist die Lenkbombe das ultimative Eliminierungssystem gegen mehrere Feinde für den einmaligen Gebrauch. Die Aktivierung dieses am Rücken getragenen Gerätes bewirkt das fortlaufende Abfeuern von Raketen, die über einen weiten Bereich automatisch ihr Ziel suchen."
"asw_wdesc_medkit"	"Ein kleines, individuelles Erste-Hilfe-Paket für die Selbstbehandlung von Wunden im Einsatz. Entwickelt von der SynTek Pharmaceutical Division."
"asw_wdesc_stims"	"Eine wirksame Injektion, frisch von der SynTek Pharmaceutical Division. In Zeiten großer Gefahr können sich die IAF-Trupps dieses Adrenalin verabreichern um damit ihr Reaktions- und Wahrnehmungsvermögen zu erhöhen. Indem es innerhalb weniger Sekunden wirkt, kann dieses Medikament in einer schwierigen Situation über Leben oder Tod entscheiden und den Marine anschließend klaren Gedankens und bereit für den nächsten Schritt hinterlassen."
"asw_wdesc_sentry"	"Die ASG ist eine hocheffiziente, vollautomatische Wächter mit Freund-Feind-Erkennung. Sie arbeitet auf Grundlage einer großen Anzahl von Einflussfaktoren, inklusive Körpermerkmal- und Breitband-Bilderkennung. Sie besteht aus einer großkalibrigen Autokanone auf einem vom Benutzer frei einstellbarem Drehgestell."
"asw_wdesc_sentry_flamer"	"Eine automatische, hochwarme Brandgeschoss-Wächter. Niedrige Gleitlager erlauben ein perfektes Zielen, sogar auf die schnellsten Ziele."
"asw_wdesc_sentry_cannon"	"Feuert hoch-beschleunigende Kugeln, die imstande sind extreme Mengen an Schaden über große Distanzen zu verursachen, dabei werden die größten Hitzesignaturen priorisiert."
"asw_wdesc_sentry_freeze"	"Feuert einen Strahl flüssigen Stickstoffs ab, um einen Schwarm für einige Zeit zu vereisen."
"asw_wdesc_tesla_trap"	"Stellt sich selbst in aktive Verteidigung und zerstört sich selbst, sobald der Strom verbraucht wurde. Feuert Hochspannungsladungen um Feinde in der Nähe zu fixieren."
"asw_wdesc_ammobag"	"Ein von der IAF standardmäßig ausgegebenes Paket, welches zusätzliche Munition für bestimmte Waffen enthält. Der Marine der die Munitionstasche trägt, kann während der Mission Magazine an alle Marines die Nachschub benötigen verteilen. Auf Grund der hohen Menge an Munition in der Tasche, ist es ratsam diese von allen Flammen fernzuhalten."
"asw_wdesc_medsatchel"	"Die Standardausgabe des IAF-Erste-Hilfe-Sets beinhaltet medizinisches Equipment für einen trainierten Sanitäter. Das Set enthält genug Vorräte für mehrere Verwundete. Des weiteren sind mehrere Sekundärladungen zur Selbstheilung vorhanden."
"asw_wdesc_healgun"	"Ein standardmäßiges IAF-Heilgewehr, das entwickelt wurde, um verletzte Personen unterwegs zu versorgen. Nur verfügbar für trainierte Sanitäter, stellt das Heilgewehr eine mobile, leichte und eine in der Hand gehaltene Version des Medkits dar. Es fokussiert sich auf einen einzelnen Patienten und heilt diesen direkt, ohne dass die Einheit dadurch aufgehalten wird. Das Heilgewehr kann durch das Alternativ-Feuern auch zum Selbstheilen verwendet werden."
"asw_wdesc_heal_grenade"	"Wenn das IAF-Medkit aktiv ist, heilt es die Wunden und die Verseuchung aller Marines die sich im Radius des Kits befinden für 20 durchgängige Sekunden oder bis es aufgebraucht ist. Sanitäter die bessere Heilungsfähigkeiten besitzen, erhalten mehr Medkits."
"asw_wdesc_pistol"	"Das M73 ist eine leichte, aber äußerst durchschlagsfähige semi-automatische Handfeuerwaffe mit einem versetzten 16 Schuss Magazin. Durch die hohe Verlässlichkeit ist sie seit einem guten Jahrzehnt eine Standardwaffe in der IAF."
"asw_wdesc_flares"	"Die SM75-Gefechtsfackeln sind spezielle Magnesiumfackeln, die von der SynTek Megacorporation zusammen mit anderen standardmäßigen Schusswaffen entwickelt wurden. Neben dem Erleuchten eines Bereichs, senden die Fackeln auch eine bestimmte Wellenlänge des Gegenlichts zurück, die das Anvisieren erleichtert und es den Waffen ermöglicht, jeglichen Feind im Licht des Magnesiums automatisch zu erfassen."
"asw_wdesc_railgun"	"Das IAF-Lasergewehr benutzt einen hybriden Feuermechanismus um Mündungsgeschwindigkeiten von über 35 km/sec zu erreichen. Die rüstungsdurchdringenden Kugeln werden durch eine explosive und elektromagnetische Energieentladung, welche von Zwillingsschienenen innerhalb der Waffe generiert werden, angetrieben. Diese Waffe ist nicht für allgemeine Kämpfe zu empfehlen, da sie für Angriffe mit hohem Schaden gegenüber einzelnen Zielen entworfen wurde."
"asw_wdesc_mlaser"	"Ein von CHOBS hergestellter 550MW Hochleistungspräzisionslaser zum leichten Durchtrennen von Gestein. Minenlaser werden üblicherweise in Außenweltkolonien genutzt und sind ein wesentlicher Bestandteil jeder großen Rohstoffgewinnung."
"asw_wdesc_chainsaw"	"Eine zivile Kettensäge - Wird benutzt, um durch Holz oder andere weiche Materialien zu schneiden."
"asw_wdesc_tesla_gun"	"Geplant war sie als Werkzeug als Starthilfe für schwere Ausrüstung, als man jedoch herausfand, dass die 24 bis 30 Ampere und die 25 Kilovolt die perfekte Mischung für die Zerstörung von Alien-Innereien ist, wurde aus dem Werkzeug eine Waffe. Die IAF Tesla-Kanone ist so kalibriert, dass sie menschliche Biometrie erkennt und so Unfällen durch Beschuss eigener Truppen vorbeugt. Wird sie jedoch auf in der Nähe befindliche außerirdische Lebensformen angewendet, so springt der elektrische Strahl über mehrere Feinde hinweg."
"asw_wdesc_ammosatchel"	"Eine Standardausgabe des IAF-Munitionspakets enthält einsetzbare Munition für alle Waffentypen, die im Gebiet genutzt werden. Jedes Paket enthält 3 Munitionskisten."
"asw_style"	"Spieltyp:"
"asw_gamestyle_normal"	"Normal"
"asw_gamestyle_carnage"	"Gemetzel"
"asw_gamestyle_uber"	"Extrem"
"asw_gamestyle_hardcore"	"Hardcore"
"asw_unlocked_format"	"%s1%s2%s3"
"asw_unlocked_uber_format"	"Mission unter %s1 abgeschlossen - Extrem-Modus freigeschaltet!\n"
"asw_unlocked_carnage"	"Mission im wahnsinnigen Schwierigkeitsgrad abgeschlossen - Gemetzel-Modus freigeschaltet!\n"
"asw_unlocked_hardcore"	"Mission ohne Verluste abgeschlossen - Hardcore-Modus freigeschaltet!\n"
"asw_beat_speedrun_format"	"Mission innerhalb der Speedrun-Zeit beendet! (%s1)\n"
"asw_best_kills_format"	"Meiste Kills: %s1"
"asw_best_time_format"	"Beste Zeit: %s1"
"asw_newbest_kills_format"	"NEUER REKORD - Vorherige meiste Kills: %s1"
"asw_newbest_time_format"	"NEUER REKORD - Vorherige beste Zeit: %s1"
//"asw_loading_hint_vereon"	"Vereon XII     Ambient Temperature: 242 Degrees Kelvin\nMineral composition rating: 8.4   Sovereignty:  SynTek Megacorporation"
"asw_loading_hint_vereon"	""
"asw_loading_hint_labs1"	""
"asw_loading_hint_labs2"	""
"asw_loading_hint_landingbay"	""
"asw_loading_hint_mine1"	""
"asw_loading_hint_mine2"	""
"asw_loading_hint_mine3"	""
"asw_loading_hint_office"	""
"asw_loading_hint_plant1"	""
"asw_loading_hint_plant2"	""
"asw_loading_hint_plant3"	""
"asw_loading_hint_sewers1"	""
"asw_loading_hint_sewers2"	""
"asw_loading_hint_sewers3"	""
"asw_loading_hint_sewers4"	""
"asw_tutorial_brief"	"Hier ist der IAF-Kommandant an den Team-Kommandanten. Wir haben auf dem Stützpunkt hier auf Vereon XII einige Vorfälle gehabt. Wir haben Berichte von Schwarm-Attacken auf die SynTek-Mitarbeiter und Kolonie-Infrastruktur. Ihr Team muss sich umgehend neu gruppieren und nach Norden vorstoßen. Sie müssen die Oberflächenaufzeichnungen herunterladen."
"asw_tutorial_brief2"	"Wir haben den Funkkontakt zu Crash und Bastille verloren. Damit der Kontakt wiederhergestellt werden kann, muss Sarge ihre letzten bekannten Positionen aufsuchen. Los Kommandant!"
"asw_tutorial_barricade"	"Wir können zahlreiche Notbarrikaden über den ganzen Außenposten verteilt feststellen. Vermutlich von verzweifelten Kolonisten, die versucht haben, ihre armen Seelen zu retten."
"asw_tutorial_barricade2"	"Sie haben uneingeschränkte Feuererlaubnis in diesem Planetensystem. Wenn euch etwas im Weg steht, vernichtet es. Oberkommando Ende."
"asw_tutorial_button"	"Benutze das Bedienfeld der Tür, um Zugang zu erlangen und Richtung Norden fortzufahren."
"asw_tutorial_biomass"	"Sie sehen hier Schwarm-Biomasse, Kommandant, ein klares Anzeichen für Schwarm-Verseuchung. Hässliches Zeug. Es bedeutet der Schwarm versucht sich hier eine permanente Präsenz aufzubauen."
"asw_tutorial_biomass2"	"Es kann mit Feuer zerstört werden, verwende den Flammenwerfer, um es zu beseitigen - sofort."
"asw_tutorial_melee"	"Sie sollten Munition sparen, wann immer es möglich ist. Benutze deshalb deine Nahkampfattacken um den Weg freizumachen."
"asw_tutorial_cutting"	"Diese Tür wurde zugeschweißt. Verwende das Schweißwerkzeug, um sie aufzuschneiden."
"asw_tutorial_team"	"Gut gemacht Kommandant! Sie haben Sarge gefunden und wir haben den Funkkontakt wiederhergestellt."
"asw_tutorial_team2"	"Mach Gebrauch der beiden Marines während Sie nach Norden vorrücken. IAF-Kommando out."
"asw_tutorial_hacking"	"Sicherheitsinformationen zufolge ist diese Türe fest verschlossen. Du kannst sie zerstören, aber wir empfehlen Ihnen, dass Sie die technischen Fähigkeiten von Crash einsetzen, um das Bedienfeld der Tür zu hacken."
"asw_tutorial_flares"	"Wir stellen einen Stromausfall in diesem Abschnitt des Korridors fest. Nehmt diese Leuchtsignale und werft sie, um die Umgebung zu erhellen."
"asw_tutorial_healing"	"Kommandant, wir können Ihrer Gesundheitsanzeige entnehmen, dass Bastille verletzt ist. Veranlassen Sie ihn diese Medizinladung aufzuheben und dessen ALTERNATIV-FEUER zu benutzen um sich selbst zu heilen."
"asw_tutorial_healing2"	"Als Sanitäter kann Bastille verletzte Marines heilen. Dazu muss er nur ein Medkit ablegen."
"asw_tutorial_positioning1a"	"Achtung Kommandant, wir haben hier zahlreiche Thermalsignaturen aus mehreren Richtungen, welche zu Ihrer Position vorrücken. Es kommt noch schlimmer, denn die Tür ist stark versiegelt. Eure Waffen werden sie nicht aufbrechen können."
"asw_tutorial_positioning1b"	"Wir versuchen die Tür ferngesteuert zu öffnen, aber Sie müssen bei den markierten Positionen halten und die Attacke abwehren."
"asw_tutorial_positioning1c"	"Das wäre es Kommandant! Die Stromversorgung der Tür ist wiederhergestellt. Sie können nun weiter nach Norden vorstoßen."
"asw_tutorial_positioning"	"Schlechte Neuigkeiten, ein großer Schwarmangriff kommt direkt auf euch zu! Befehle Sarge eine Wächter im markierten Bereich aufzubauen."
"asw_tutorial_positioning2"	"Richte jetzt die Wächter aus, um eine Seite abzudecken und verteidige die restlichen Seiten von den markierten Defensivpositionen aus!"
"asw_tutorial_positioning_no_turret"	"Schlechte Nachrichten Kommandant, ein großer Angriff kommt auf euch zu! Verteidigt von den markierten Positionen aus!"
"asw_tutorial_sealing1"	"Es sind mehr Schwarmdrohnen von Osten her auf dem Weg zu euch. Bring dein Team rein, aber schnell."
"asw_tutorial_sealing2"	"Heb das tragbare Schweißgerät auf und versiegel die verstärkte Tür. Das sollte sie abhalten euch zu folgen."
"asw_tutorial_ammo1"	"Gut, ihr habt eine Vorratskiste gefunden. Sie sollten immer ein Auge auf die Munition Ihres Teams haben, damit Sie das Meiste aus der gefundenen Munition machen können."
"asw_tutorial_ammo2"	"Wenn du nachlädst, verlierst du verbleibenden Kugeln des aktuellen Magazins. Lade also nur nach, wenn es absolut notwendig ist."
"asw_tutorial_pos3"	"Passen Sie auf Kommandant. Wir haben einen weiteren Schwarm gesichtet, welcher aus nordwestlicher Richtung auf euch zukommt. Unsere Aufnahme dieses Bereiches ist undeutlich, das könnte an radioaktiven Störungen in diesem Raum liegen."
"asw_tutorial_pos3b"	"Analysiere deine Umgebung und bedenke mögliche Verteidigungspunkte, um deine Marines zu platzieren. Schnell Kommandant, der Schwarm kommt auf euch zu!"
"asw_tutorial_follow1"	"Okay Kommandant, der Wärmescan des Bereiches hat keine ungewöhnlichen Ergebnisse gebracht. Du kannst deinem Team nun befehlen, dir zu folgen."
"asw_tutorial_follow2"	"Sei dir bewusst, dass deine Marines im Folgen-Modus langsamer reagieren und mit weniger Genauigkeit schießen. Nutze diesen Modus nur, wenn ihr nicht im direkten Kampf seid."
"asw_tutorial_follow3"	"Ein Befehl zum Halten der Position kann erteilt werden um schnell den Folgen-Modus zu verlassen und in eine defensive Formation zu wechseln. Ein Marine der eine Position hält ist sehr leistungsfähig und kann die Richtung in die er blickt extrem effizient decken."
"asw_tutorial_data1"	"Dieser Computer verfügt über wichtige Informationen für die Planung der Operation hier auf Vereon XII. Wir benötigen Thermalsignaturen und eine Analyse der Umgebungsatmosphäre um auf die Situation vorbereitet zu sein."
"asw_tutorial_data2"	"Die Informationen sind streng geheim, daher benötigt ihr einen Techniker um eindringen zu können. Ist eine echte Großzügigkeit unserer Freunde bei SynTek. Also, an die Arbeit, Kommandant!"
"asw_tutorial_exit"	"Kommandant, vergewissere dich, dass alle Ziele erfüllt sind, bevor du versuchst das Einsatzgebiet zu verlassen. Wir benötigen dein Team und die Daten bevor wir fortfahren können."
"asw_tutorial_exit2"	"Durchsuchet die nähere Umgebung nach einem Bedienfeld eines Computers und ladet die kritischen Daten herunter."
"asw_tutorial_alt_fire"	"Kommandant, heben Sie dieses Gewehr auf und benutzen Sie dessen Alternativfeuer um diese Kisten wegzusprengen."
"asw_tutorial_parasites1"	"Selbst in gepanzerten Anzügen kann dein Team genauso von Parasiten infiziert werden. Gehe in der Nähe der Parasiteneier mit äußerster Vorsicht vor."
"asw_tutorial_parasites2"	"Falls das Schlimmste passiert und ein Teammitglied von einem Parasit infiziert wird, muss der Sanitäter schnell handeln und den Infizierten am Leben halten bis die Verseuchung vorüber ist."
"asw_labs_bio1"	"ZUGRIFF VERWEIGERT:\nBIOLOGISCHE GIFTSTOFFE INNERHALB DER FORSCHUNGSSTATION ENTDECKT"
"asw_labs_bio2"	"Warnung: Ein Klasse 4-Organismus wurde in Sektor 1 der SynTek Forschungsstation entdeckt. Der Quarantäne-Alarm hat gemäß Protokoll #45/82763 der Interstellaren Allianz das Stromnetzwerk heruntergefahren. Bitte entfernen Sie alle fremden Klasse 4-Organismen, um Zugang zu erhalten."
"asw_button_start"	"START"
"asw_button_spectate"	"Zuschauen"
"asw_button_ready"	"BEREIT"
"asw_button_continue"	"FORTSETZEN"
"asw_button_credits"	"CREDITS"
"asw_button_new_campaign"	"NEUE FELDZUG"
"asw_button_restart"	"NEU STARTEN"
"asw_button_finish"	"Fertig"
"asw_button_restart_mis"	"EINSATZ NEU STARTEN"
"asw_button_next"	"WEITER"
"asw_button_prev"	"ZURÜCK"
"asw_button_previous"	"Zurück"
"asw_button_selectm"	"Marine auswählen"
"asw_button_deselectm"	"Marine abwählen"
"asw_button_reserved"	"Marine reserviert"
"asw_button_alreadysel"	"Bereits ausgewählt"
"asw_button_marinedead"	"Marine gefallen"
"asw_button_missionfull"	"Einsatz voll"
"asw_button_retcamp"	"Feldzug-Auswahl"
"asw_ingame_restart_title"	"EINSATZ WIRD NEUGESTARTET"
"asw_ingame_restart_5"	"Einsatz wird neugestartet in 5..."
"asw_ingame_restart_4"	"Einsatz wird neugestartet in 4..."
"asw_ingame_restart_3"	"Einsatz wird neugestartet in 3..."
"asw_ingame_restart_2"	"Einsatz wird neugestartet in 2..."
"asw_ingame_restart_1"	"Einsatz wird neugestartet in 1..."
"asw_ingame_restart_in"	"Einsatz wird neugestartet in: %s1"
"asw_force_ready_5"	"Erzwinge Bereitschaft in 5..."
"asw_force_ready_4"	"Erzwinge Bereitschaft in 4..."
"asw_force_ready_3"	"Erzwinge Bereitschaft in 3..."
"asw_force_ready_2"	"Erzwinge Bereitschaft in 2..."
"asw_force_ready_1"	"Erzwinge Bereitschaft in 1..."
"asw_force_startm"	"Nicht alle Spieler sind bereit. Möchtest du den Einsatz trotzdem beginnen?"
"asw_force_continuem"	"Nicht alle Spieler sind bereit. Möchtest du trotzdem speichern und fortsetzen?"
"asw_force_restartm"	"Nicht alle Spieler sind bereit. Möchtest du trotzdem neu starten?"
"asw_force_ready"	"Bereitschaft erzwingen"
"asw_force_ready_delayed"	"Bereitschaft erzwingen (%s1)"
"asw_force_wait"	"Abbrechen"
"asw_force_yes"	"Ja"
"asw_squad_not_full"	"Achtung, Kommandant. Sie haben kein vollständiges Team zur Verfügung. Wenn du versuchst, diesen Einsatz ohne ein komplettes Team zu erledigen, wird die Schwierigkeit deutlich steigen. Möchtest du den Einsatz wirklich starten?"
"asw_skill_to_spend"	"Warnung Kommandant. Einer Ihrer Marines hat noch Fähigkeitspunkte zu vergeben. Möchtest du den Einsatz wirklich starten?"
"asw_start_anyway"	"Einsatz beginnen"
"asw_cancel"	"Abbrechen"
"asw_force_retcamp"	"Einige Spieler sind noch nicht bereit. Möchtest du den Einsatz trotzdem beenden und zur Feldzug-Auswahl zurückkehren?"
"asw_confirm_retcamp"	"Bist du sicher, dass du diesen Einsatz abbrechen und zur Feldzug-Auswahl zurückkehren willst?"
"asw_debrief_complete"	"EINSATZ ABGESCHLOSSEN"
"asw_debrief_failed"	"EINSATZ FEHLGESCHLAGEN"
"asw_default_debrief"	"Ziele erfolgreich abgeschlossen. Gute Arbeit, Marines."
"asw_tutorial_db1"	"Die IAF-Zentrale analysiert die Daten, welche Ihr Team abgerufen hat und wird sofort mit der Planung der Mission hier auf Vereon XII beginnen."
"asw_tutorial_db2"	"Das Kommando hat Ihre Leistung als zufriedenstellend erachtet und ernennt Sie als Team-Kommandanten für den ersten Vorstoß in die Jakobsruh-Kolonie. Das Mannschaftsschiff, die Bloodhound, befindet sich auf dem Weg um Ihre Männer vom Stützpunkt abzuholen."
"asw_tutorial_db3"	"Die Operation wird um 1700 eingeleitet. Warten Sie auf weitere Befehle, Kommandant."
"asw_landingbay_db1"	"Die Analyse des Flugrekorders aus der Rettungskapsel zeigt einige Schiffe, die erfolgreich die Umlaufbahn durchbrechen und Veron XII verlassen konnten. Sieht nach einer Hand voll SynTek Offizieren und Kolonisten aus."
"asw_landingbay_db2"	"Wir haben zudem erfahren, dass ein kleiner Container die Atmosphäre verlassen hat ohne ID Codes auszusenden. Alle Daten über Start und Flugbahn dieses Containers wurden von unbekannten Personen verschlüsselt. Wir sind dabei die nähere Umgebung mit Aufklärungsschiffen zu durchsuchen, jedoch sind die Chancen diesen Container zu finden auf Grund dessen Größe und der unbekannten Flugbahn sehr gering."
"asw_landingbay_lift1"	"Alle unregistrierten Mitarbeiter müssen sich im Fahrstuhl befinden, bevor jener aktiviert werden kann."
"asw_outside_db1"	"Gut gemacht Kommandant. Sie haben die Pipeline zerstört. Das sollte massive Schwarmbewegungen aus der Kolonie verhindern. Wir werden das weiterhin aus dem Orbit beobachten."
"asw_outside_db2"	"SynTek wird über den Besiedlungscode 572/C über alle Eigentumsbeschädigungen informiert."
"asw_plant_db1"	"Wir sehen den Reaktor wieder mit voller Effizienz laufen. Den Strom der Kolonie wiederherzustellen ist ein wichtiger Schritt im Restaurierungsprozess. Das wird den Aufräumteams ihre Arbeit erleichtern."
"asw_plant_db2"	"."
"asw_office_db1"	"Die Zerstörung der Biomasseninfektion innerhalb des Zentralkoloniegebäudes hat den Schwarmübergriff aufgehalten und wird sie in die Defensive zwingen."
"asw_office_db2"	"Datenaufzeichnungen zufolge versuchten einige SynTek Security Mitarbeiter die Infektion zu bekämpfen. Wir können zum jetzigen Zeitpunkt annehmen, dass sie erfolglos waren."
"asw_labs_db1"	"Der IAF-Geheimdienst wird die von Ihnen geborgenen Daten analysieren, Kommandant. Es sieht so aus, als hätten in dieser Forschungsanlage mehrere Verstöße gegen das Interstellare Recht stattgefunden, die unmittelbar zur Destabilisierung und Verseuchung geführt haben. Wir werden der Interstellaren Allianz vollständig Bericht erstatten."
"asw_labs_db2"	"Wir können immer noch eine erhebliche Schwarmpräsenz innerhalb der Kolonie feststellen. Rücken Sie umgehend zur nächsten Missionsposition vor, Kommandant. Wir haben Ungeziefer auszurotten."
"asw_sewers_db1"	"Da die Zugangstunnel zur Kanalisation nun versiegelt sind, hat der Schwarm nur noch einen Weg zur Oberfläche. Es ist Zeit, den Kampf zu ihnen zu tragen und ernsthaften Schaden anzurichten."
"asw_mine_db1"	"Ausgezeichnete Arbeit, Kommandant. Die durch Ihr Team ausgelöste thermonukleare Detonation hat den Großteil des Schwarms unterhalb der Oberfläche vernichtet. Wir schätzen, dass mehr als 200 Eier und zahllose Schwarmdrohnen durch die Explosion ausgelöscht wurden."
"asw_mine_db2"	"Die Aufräumflotte erreicht die Umlaufbahn in diesem Moment und beginnt einen atmosphärischen Dekontaminationsvorgang um 0500. Wir erwarten das Mannschaftsschiff, die Bloodhound, und Ihr Team hier wieder um 0430. Flammenwerferteams stehen für eine manuelle Säuberung jeglicher verbleibender Schwarmtruppen und Verseuchungen bereit."
"asw_mine_db3"	"Genießen Sie den Kryo-Schlaf so lange Sie können, Kommandant."
"asw_ob_landing_1t"	"Zugang zur Basis erlangen"
"asw_ob_landing_1"	"Das Mannschaftsschiff, die Bloodhound, wird am äußeren Landungshafen andocken. Ihr Team muss durch das anliegende Gebiet preschen und Zugang zu den inneren Perimetern erlangen."
"asw_ob_landing_1b"	"Wir erwarten, dass die Türen in diesem Abschnitt verriegelt sind, weshalb ein Techniker für diesen Einsatz unbedingt notwendig ist."
"asw_ob_landing_2t"	"Flugpläne herunterladen"
"asw_ob_landing_2"	"Das IAF-Oberkommando benötigt Flugpläne aller Schiffe, die Vereon XII in den vergangenen 90 Tagen verlassen haben. Unsere Sensoren zeigen eine unbenutzte Rettungskapsel in Landebucht 7, die immer noch mit dem Verkehrsleitsystem der Kolonie verbunden ist."
"asw_ob_landing_2b"	"Ein Techniker muss in das System eindringen und alle Flugpläne herunterladen."
"asw_ob_landing_3t"	"Gelangen Sie zum Ausgang des Landefelds"
"asw_ob_landing_3"	"Nachdem Sie die Flugpläne heruntergeladen haben, benutzen Sie den Frachtaufzug im Norden, um auf die unteren Ebenen zu gelangen. Rücken Sie zur Kolonie vor und suchen Sie dort nach Überlebenden."
"asw_ob_landing2_2t"	"Aktivieren Sie den Frachtaufzug und fahren Sie nach unten"
"asw_ob_landing2_2"	"Unsere Pläne der Anlage zeigen einen großen Frachtaufzug nördlich Ihres Ausgangspunktes. Benutzen Sie den Aufzug, um auf die untere Ebene zu gelangen und begeben Sie sich zum Ausgang des Depots."
"asw_ob_landing2_1t"	"Betreten Sie das Außengelände der Anlage"
"asw_ob_landing2_1"	"Rücken Sie nach dem Abstieg zum Ausgang der Anlage vor und führen Sie Ihr Team nach draußen."
"asw_cargo_db1"	"Okay Team, checkt eure Ausrüstung und trefft Vorbereitungen für einen kurzen Oberflächenlauf. Atmosphärische Lageberichte weisen auf Temperaturen unter Null hin."
"asw_cargo_db2"	""
"asw_ob_outside_1t"	"Erlangen Sie Zugang zur Pipeline"
"asw_ob_outside_1"	"Scans zeigen starke Schwarmaktivität in der Nähe der Pipeline. Machen Sie die betroffene Pipeline ausfindig."
"asw_ob_outside_2t"	"Zerstören Sie die verseuchte Pipeline"
"asw_ob_outside_2"	"Die Pipeline wird vom Schwarm genutzt um zur Kolonie zu gelangen. Dies bietet eine perfekte Eindämmungsmöglichkeit. Nutzen Sie den vorhandenen Bau-Sprengstoff um die Pipeline zu zerstören."
"asw_ob_outside_3t"	"Gelangen Sie zum Eingang des Koloniereaktors"
"asw_ob_outside_3"	"Nachdem alle anderen Ziele erreicht wurden, versuchen Sie zum Eingang des Kolonie-Reaktors zu gelangen. Der Eingang befindet sich im Norden, auf der anderen Seite der Zugbrücke."
"asw_ob_plant_2t"	"Bringen Sie den Reaktor zum Laufen"
"asw_ob_plant_2"	"Erlangen Sie Zugang zum Reaktor-Kontrollraum und bringen Sie das Stromnetz wieder zum Laufen."
"asw_ob_plant_3t"	"Erreichen Sie den Nordausgang"
"asw_ob_plant_3"	"Sobald der Strom wiederhergestellt ist, preschen Sie durch die Anlage zum Nordausgang und eliminieren Sie jeden Feind, dem Sie begegnen."
"asw_ob_office_3t"	"Zerstöre die Alien-Eier"
"asw_ob_office_3"	"Sie müssen alle Alien-Eier im Wohnkomplex finden und zerstören. Dies ist der erste Schritt zur Eindämmung des Schwarms."
"asw_ob_office_3b"	"Frühe Scans deuten darauf hin, dass die Alien-Eier im Bereich von Warmluftquellen vermehrt auftreten. Ihre Einheit muss einen gründlichen Check des stationären Belüftungssystems durchführen."
"asw_ob_office_4t"	"Verbrennen Sie die Biomasse"
"asw_ob_office_4"	"Rundum-Scans zeigen einen Anstieg von biologischem Material des Schwarms im Wohnkomplex. Dies ist ein frühes Zeichen für den Bau eines Nestes."
"asw_ob_office_4b"	"Alle erheblichen biologischen Massenansammlungen des Schwarms müssen durch den Einsatz großer Hitze zerstört werden."
"asw_ob_office_4c"	"Die Missionsziele setzten mindestens einen Flammenwerfer voraus. Das IAF-Kommando empfiehlt zusätzliche Flammenwerfer mitzunehmen, um die vollständige Sterilisation des Komplexes zu erleichtern."
"asw_ob_office_5t"	"Flüchten Sie mit den Aufzügen"
"asw_ob_office_5"	"Wenn alle Ziele erfüllt sind, müssen Sie sich zum Verlassen des Bereiches in Richtung Norden zum Aufzug begeben."
"asw_ob_sewer_2t"	"Zerstöre die Alien-Eier"
"asw_ob_sewer_2"	"Die Feuchtigkeit in diesem Areal hat einen idealen Brutplatz für Schwarm-Parasiten geschaffen. Zerstöre alle Alien-Eier, die sich in der Kanalisation befinden."
"asw_ob_sewer_3t"	"Versiegeln Sie den Zugangstunnel"
"asw_ob_sewer_3"	"Rundum-Scans zeigen, dass der Schwarm einen alten Wartungstunnel nutzt um sich im Untergrund zwischen zwei Arealen des Kolonie-Komplexes zu bewegen."
"asw_ob_sewer_3b"	"Ihre Einheit muss den Tunneleingang ausfindig machen und versiegeln. Dies wird die Schwarm-Bewegungen einschränken und macht es Aufräumtrupps leichter, die Kolonie von der Verseuchung zu säubern."
"asw_ob_sewer_4t"	"Finden Sie einen Ausgang und flüchten Sie"
"asw_ob_sewer_4"	"Scans offenbaren eine Lücke in der Wasseraufbereitungsanlage bei der nordwestlichen Wand. Bewegen Sie sich, sobald Sie die Missionsziele erfüllt haben, mit deiner Einheit durch die Lücke um wieder zur Oberfläche zu gelangen."
"asw_ob_mine_2t"	"Aktivieren Sie die Seilbahn"
"asw_ob_mine_2"	"Machen Sie die Transformatorstation für die Seilbahn ausfindig und reaktivieren Sie sie. Dies wird den Sprengkopf auf seinen Weg zur Brutkammer bringen."
"asw_ob_mine_3t"	"Säubern Sie den Weg des Sprengkopfs"
"asw-ob-mine_3"	"Halten Sie den Weg des Sprengkopfs frei."
"asw_ob_mine_4t"	"Zünden Sie den Sprengkopf"
"asw_ob_mine_4"	"Aktivieren Sie die Detonationssequenz und jagen Sie diese Käfer in die Hölle, wenn der Sprengkopf in Position ist."
"asw_ob_mine_5t"	"Flüchten Sie mit der Bloodhound"
"asw_ob_mine_5"	"Nachdem Sie alle anderen Ziele erledigt haben, begeben Sie sich mit Ihrem Team zur Laderampe in südöstlicher Richtung, um dort evakuiert zu werden."
"asw_galactic_map_core_systems"	"KERNSYSTEME"
"asw_galactic_map_syntek_megacorporation"	"SYNTEK MEGACORPORATION"
"asw_galactic_map_trust_media_hub"	"TRUST-MEDIEN-HUB"
"asw_galactic_map_humanist_protectorate"	"DAS HUMANISTISCHE PROTEKTORAT"
"asw_galactic_map_iaf_academy"	"IAF-Akademie"
"asw_galactic_map_paradise_supplies"	"PARADISE VORRÄTE"
"asw_galactic_map_enigma_research_group"	"ENIGMA FORSCHUNGSGRUPPE"
"asw_galactic_map_united_industries"	"VEREINIGTE INDUSTRIEN"
"asw_galactic_map_chosen"	"DIE AUSERWÄHLTEN"
"asw_galactic_map_frontier_pharmaceuticals"	"FRONTIER-PHARMAZEUTIKA"
"asw_galactic_map_penitentiary_cluster"	"DER GEFÄNGNISBLOCK"
"asw_galactic_map_void"	"THE VOID"
"asw_galactic_map_infested_systems"	"VERSEUCHTE SYSTEME"
"asw_galactic_map_hatal_9"	"Hatal 9"
"asw_galactic_map_anhaven_ruins"	"Die Anhaven Ruinen"
"asw_galactic_map_jacobs_rest"	"Jacobsruhe"
"asw_campaign_initializing"	"Initialisiere..."
"asw_campaign_generating_map"	"Generiere Karte..."
"asw_campaign_retries_label"	"Versuche: %s1"
"ASW_Ammo_Bag_Title"	"Munitionstasche"
"asw_drop_r_ammo"	"Gewehrmunition fallen lassen"
"asw_drop_ag_ammo"	"Autogun-Munition fallen lassen"
"asw_drop_sg_ammo"	"Schrotflintemunition fallen lassen"
"asw_drop_v_ammo"	"Vindicator-Munition fallen lassen"
"asw_drop_fl_ammo"	"Flammenwerfermunition fallen lassen"
"asw_drop_rg_ammo"	"Lasermunition fallen lassen"
"asw_drop_pdw_ammo"	"PDW-Munition fallen lassen"
"asw_drop_pi_ammo"	"Pistolenmunition fallen lassen"
"asw_mouse_wheel_up"	"Mausrad hoch"
"asw_mouse_wheel_down"	"Mausrad runter"
"asw_mouse1"	"Linke Maustaste"
"asw_mouse2"	"Rechte Maustaste"
"asw_mouse3"	"Mittlere Maustaste"
"asw_360_a"	"A"
"asw_360_b"	"B"
"asw_360_x"	"X"
"asw_360_y"	"Y"
"asw_360_left_bumper"	"Linke Schultertaste"
"asw_360_right_bumper"	"Rechte Schultertaste"
"asw_360_back"	"Zurück"
"asw_360_start"	"Start"
"asw_360_left_stick_in"	"Linker Stick rein"
"asw_360_right_stick_in"	"Rechter Stick rein"
"asw_360_dpad_up"	"D-Pad hoch"
"asw_360_dpad_right"	"D-Pad rechts"
"asw_360_dpad_down"	"D-Pad runter"
"asw_360_dpad_left"	"D-Pad links"
"asw_360_right_trigger"	"Rechter Trigger"
"asw_360_left_trigger"	"Linker Trigger"
"asw_360_left_stick_right"	"Linker Stick rechts"
"asw_360_left_stick_left"	"Linker Stick links"
"asw_360_left_stick_down"	"Linker Stick runter"
"asw_360_left_stick_up"	"Linker Stick hoch"
"asw_360_right_stick_right"	"Rechter Stick rechts"
"asw_360_right_stick_left"	"Rechter Stick links"
"asw_360_right_stick_down"	"Rechter Stick runter"
"asw_360_right_stick_up"	"Rechter Stick hoch"
"asw_server_options"	"Server-Optionen"
"asw_max_players"	"Max. Spieler"
"asw_server_password"	"Server-Passwort"
"asw_host_name"	"Server-Name"
"asw_lan_server"	"LAN-Server"
"asw_select_difficulty"	"Schwierigkeitsgrad"
"asw_difficulty_chooser_easy"	"Leicht"
"asw_difficulty_chooser_normal"	"Normal"
"asw_difficulty_chooser_hard"	"Schwer"
"asw_difficulty_chooser_insane"	"Wahnsinnig"
"asw_difficulty_chooser_easyd"	"Wenn du sehr wenig Erfahrung mit Computerspielen hast, probier mal \"Leicht\" aus. Gegner bewegen sich langsamer und sind einfacher zu erledigen."
"asw_difficulty_chooser_normald"	"Wenn du noch wenig Erfahrung mit Alien Swarm hast, empfiehlt sich \"Normal\"."
"asw_difficulty_chooser_hardd"	"Falls du schon einmal Alien Swarm gespielt hast, wähle diese Einstellung. Gegner bewegen sich schneller und sind schwerer zu töten. Team-Taktiken werden wichtiger um zu Überleben. Dafür gibt es aber auch mehr Erfahrungspunkte."
"asw_difficulty_chooser_insaned"	"Falls deine Einheit den Feldzug auf \"Schwer\" geschafft hat, solltest du \"Wahnsinnig\" als Herausforderung probieren! Gegner bewegen sich mit erhöhter Geschwindigkeit, fügen mehr Schaden zu und sind schwerer zu töten."
"asw_terminal_access"	":: Terminal-Zugriff ::"
"asw_syntek_pda"	":: SynTek PDA ::"
// swarmopedia
"asw_so_topics"	"Datenbankdateien:"
"asw_so_corps"	"Unternehmen"
"asw_so_factions"	"Fraktionen"
"asw_so_marines"	"Marines"
"asw_so_weapons"	"Waffen"
"asw_so_equip"	"Ausrüstung"
"asw_so_locations"	"Wichtige Orte"
"asw_so_enviro"	"Ökologisch"
"asw_so_swarm"	"Der Schwarm"
// corps
"asw_so_centralcredit"	"Kreditwechsel-Zentral"
"asw_so_syntek"	"SynTek Megacorporation"
"asw_so_dominic"	"Dominic Labs Inc."
"asw_so_enigma"	"Enigma Research Group"
"asw_so_frontier"	"Frontier-Pharmazeutika"
"asw_so_nanoproc"	"Nanoproc Ltd."
"asw_so_paradise"	"Paradies Nachschub"
"asw_so_phinvest"	"PH Investment Group Inc."
"asw_so_premier"	"Premier-Antriebsforschung"
"asw_so_solar"	"Solar Holding Company"
"asw_so_stellar"	"Stellar Imaging Inc."
"asw_so_teltech"	"Tel-tech Corporation"
"asw_so_trust"	"Trust Media"
"asw_so_united"	"United Industries"
"asw_so_zerog"	"Zero-G Manufacturing"
// factions
"asw_so_ia"	"Interstellare Allianz"
"asw_so_iaf"	"Interstellar Armed Forces"
"asw_so_iafcommand"	"IAF-Kommando"
"asw_so_iafint"	"IAF-Geheiminformationen"
"asw_so_iafmarines"	"IAF-Soldaten"
"asw_so_iaffleet"	"IAF-Flotte"
"asw_so_pdf"	"Planetarische Verteidigungstruppe"
"asw_so_humanist"	"Die Humanistische Protektorat"
"asw_so_chosen"	"Die Auserwählten"
"asw_so_tradel"	"Handelsvereinigungen"
// weapons
"asw_so_rifle"	"Sturmgewehr"
"asw_so_prifle"	"Prototyp-Gewehr"
"asw_so_autogun"	"Autogun"
"asw_so_shotgun"	"Schrotflinte"
"asw_so_vindicator"	"Vindicator"
"asw_so_flamer"	"Flammenwerfer"
"asw_so_pdw"	"PDW"
"asw_so_pistol"	"Pistolen"
"asw_so_sentry"	"Wächter"
"asw_so_Mines"	"Brandminen"
// equip
"asw_so_medsatchel"	"Erste-Hilfe-Kasten"
"asw_so_ammobag"	"Munitionslager"
"asw_so_medkit"	"Medikit"
"asw_so_stims"	"Adrenalin"
"asw_so_flashlight"	"Taschenlampe"
"asw_so_flares"	"Fackeln"
"asw_so_welder"	"Schweißgerät"
"asw_so_fireext"	"Feuerlöscher"
"asw_so_mining"	"Bergbau-Laser"
"asw_so_chainsaw"	"Kettensäge"
// locations
"asw_so_core"	"Kernsysteme"
"asw_so_iafacademy"	"IAF-Akademie"
"asw_so_trusthub"	"Trust-Medienschnittstelle"
"asw_so_penitent"	"Gefängnisblock"
"asw_so_hatal9"	"Hatal 9"
"asw_so_anhaven"	"Anhaven Ruinen"
"asw_so_vereon"	"Vereon XII"
"asw_so_void"	"The Void"
"asw_so_infested"	"Verseuchte Systeme"
"asw_so_cetii"	"Cetii Epsilon"
"asw_so_talaris9"	"Talaris 9"
// enviro
"asw_so_doors"	"Türen"
"asw_so_fuel"	"Treibstoffkanister"
"asw_so_console"	"Computerterminal"
"asw_so_panel"	"Tastenbedienfeld"
// swarm
"asw_so_swarm"	"Der Schwarm"
"asw_so_drone"	"Drohne"
"asw_so_parasite"	"Parasit"
"asw_so_shieldbug"	"Schildkäfer"
"asw_so_buzzer"	"Schnarre"
"asw_so_grub"	"Raupe"
"asw_so_harvester"	"Raffer"
"asw_so_queen"	"Königin"
"asw_so_biomass"	"Biomasse"
"asw_bouncing_kills"	"%s1 tötete %s2 Aliens mit abgeprallten Schüssen."
"asw_pick_stim_music"	"Adrenalin-Musik auswählen"
"asw_stim_music_types"	"Audio-Dateien (*.mp3|*.wav)"
"asw_music_import_dialog"	"Gefechtsmusik auswählen"
"asw_music_types"	"Audio-Dateien (*.mp3)"
"asw_ingame_map"	"Karte"
// Attribute affixes
"damagedone_2"	"Hohe Geschwindigkeit"
"damagedoors_2"	"Einbruch"
"damageflyers_2"	"Höchste Flughöhe"
"clipsize_2"	"Hohe Kapazität"
"firerate_2"	"Schnellfeuer"
"healonhit_1"	"Vampirisch"
"piercing_1"	"Durchdringend"
"stopping_1"	"Schwer"
"ignite_1"	"Entflammend"
"electro_1"	"Aufgeladen"
"reloadtime_2"	"Vorbereitet"
"extraammo_2"	"Erhöhte Kapazität"
"healbonus_1"	"Wiederherstellend"
"xenowoundbonus_1"	"Xeno-Wunde"
"firewall_1"	"Nitro"
"duration_1"	"Beständig"
// Attribute descriptions
"Attrib_ClipSize_Positive"	"+%s1% Magazingröße"
"Attrib_ClipSize_Negative"	"%s1% Magazingröße"
"Attrib_DamageDone_Positive"	"+%s1% Schaden"
"Attrib_DamageDone_Negative"	"%s1% Schaden"
"Attrib_DamageDoors_Positive"	"+%s1% Schaden an Türen"
"Attrib_DamageFlyers_Positive"	"+%s1% Schaden an fliegenden Zielen"
"Attrib_FireRate_Positive"	"+%s1% Schnellere Schußgeschwindigkeit"
"Attrib_FireRate_Negative"	"%s1% Langsamere Schußgeschwindigkeit"
"Attrib_HealOnHit_Positive"	"+%s1 Lebenspunkte bei Treffer"
"Attrib_HealOnHit_Negative"	"%s1 Lebenspunkte bei Treffer"
"Attrib_Piercing_Positive"	"+%s1% Durchschlagswahrscheinlichkeit"
"Attrib_Stopping_Positive"	"+%s1% Mannstoppwirkung"
"Attrib_Ignite_Positive"	"+%s1% Chance, das Ziel anzuzünden"
"Attrib_Electro_Positive"	"+%s1% Chance, das Ziel zu betäuben"
"Attrib_ReloadTime_Positive"	"+%s1% Schnellere Nachladezeit"
"Attrib_ExtraAmmo"	"+%s1 Munition"
"Attrib_HealBonus_Positive"	"+%s1% Heilen"
"Attrib_XenowoundBonus_Positive"	"+%s1% Heilungsbonus bei Verseuchung"
"Attrib_FirewallLength"	"+%s1 Feuerwand-Länge"
"Attrib_Duration_Positive"	"+%s1% Dauer"
// item qualities
"item_common"	"NORMAL"
"item_rare"	"SELTEN"
"item_unique"	"EINZIGARTIG"
// holdout
"asw_holdout_hud_wave"	"Welle: %s1"
"asw_holdout_hud_score"	"Punkte: %s1"
"asw_holdout_wave_complete"	"Welle %s1 abgeschlossen!"
"asw_holdout_wave_announce"	"- WELLE %s1 -"
"asw_holdout_get_ready"	"BEREIT MACHEN"
"asw_holdout_resupply_title"	"NACHSCHUB"
"asw_holdout_resupply_countdown"	"Nachschubsende:"
"asw_holdout_resupply_ok"	"OK"
"asw_holdout_complete"	"SIE SIND EIN GEWINNER!"
// new briefing
"nb_mission_prep"	"MISSIONSVORBEREITUNG"
"nb_ready"	"BEREIT"
"nb_start_mission"	"MISSION BEGINNEN"
"nb_leader"	"Lobby-Führer: %s1"
"nb_commander_level"	"Level: %s1"
"nb_select_marine"	"Marine auswählen"
"nb_spend_skill_points"	"Fähigkeitspunkte vergeben"
"nb_bio"	"Biografie:"
"nb_accept"	"ÜBERNEHMEN"
"nb_back"	"ZURÜCK"
"nb_okay"	"OKAY"
"nb_done"	"FERTIG"
"nb_no"	"NEIN"
"nb_yes"	"JA"
"nb_select_weapon_one"	"Waffe Eins Auswählen"
"nb_select_weapon_two"	"Waffe Zwei Auswählen"
"nb_select_offhand"	"Zusatz-Gegenstand auswählen"
"nb_weapon_description"	"Beschreibung:"
"new_weapon"	"Neu!"
"nb_objectives"	"Ziele"
"nb_objective_details"	"Details"
"nb_overview_map"	"Oberflächenkarte"
"nb_mission_title"	"Mission:"
"nb_mission_options"	"MISSIONSOPTIONEN"
"nb_difficulty_title"	"Schwierigkeitsgrad"
"nb_mission_brief"	"Missionsbeschreibung"
"nb_mission_details"	"Missionsdetails: %s1"
"nb_mission_style"	"Missionstyp:"
"nb_mission_details_button"	"MISSIONSDETAILS"
"nb_friends"	"FREUNDE EINLADEN"
"nb_skill_title"	"Fähigkeitsdetails:"
"nb_select_mission"	"Mission auswählen"
"nb_select_starting_mission"	"Startmission auswählen"
"nb_select_campaign"	"Kampagne auswählen"
"nb_launch_mission"	"WEITER"
"nb_commanders"	"KOMMANDANTEN"
"nb_next_mission"	"NÄCHSTE MISSION:"
"nb_campaign_title"	"KAMPAGNE: %s1"
"nb_weapon_unlocked"	"Neue Waffe freigeschaltet"
"nb_skill_points"	"Fähigkeitspunkte"
"nb_skill_points_fixed"	"Unverstellbar"
"nb_skill_points_custom"	"Benutzerdefiniert"
"nb_spare_skill_points"	"Verwendbare Fähigkeitspunkte:"
"nb_promotion_title"	"IAF-Beförderung"
"nb_promotion_description"	"Die IAF hat Ihnen eine Beförderung für Ihre tapfere und standhafte Entschlossenheit im Kampf gegen den Schwarm angeboten."
"nb_promotion_warning"	"WARNUNG: DIESER VORGANG SETZT SIE AUF LEVEL 1 ZURÜCK UND SPERRT JEDEN BEREITS FREIGESCHALTETEN AUSRÜSTUNGSGEGENSTAND ERNEUT"
"nb_promote"	"BEFÖRDERN"
"nb_cancel"	"ABBRECHEN"
"asw_player_promoted_1"	"%s1 hat den Titanstern erhalten."
"asw_player_promoted_2"	"%s1 hat den Karbidstern erhalten."
"asw_player_promoted_3"	"%s1 hat das Galliumkreuz erhalten."
"asw_player_promoted_4"	"%s1 hat den Platinum Stern erhalten."
"asw_player_promoted_5"	"%s1 hat den Osmium Stern erhalten."
"asw_player_promoted_6"	"%s1 hat das Iridium Medallion erhalten."
"asw_player_promoted_7"	"%s1 hat das Goldene Medallion erhalten."
"nb_promotion_medal_1"	"Titanstern"
"nb_promotion_medal_2"	"Karbidstern"
"nb_promotion_medal_3"	"Galliumkreuz"
"nb_promotion_medal_4"	"Platinum Stern"
"nb_promotion_medal_5"	"Osmium Stern"
"nb_promotion_medal_6"	"Iridium Medallion"
"nb_promotion_medal_7"	"Goldenes Medallion"
"nb_first_promotion"	"ERSTE BEFÖRDERUNG"
"nb_second_promotion"	"ZWEITE BEFÖRDERUNG"
"nb_third_promotion"	"DRITTE BEFÖRDERUNG"
"nb_fourth_promotion"	"VIERTE BEFÖRDERUNG"
"nb_fifth_promotion"	"FÜNFTE BEFÖRDERUNG"
"nb_sixth_promotion"	"SECHSTE BEFÖRDERUNG"
"nb_seventh_promotion"	"SIEBENTE BEFÖRDERUNG"
"marine_class_officer"	"Offiziere"
"marine_class_sw"	"Waffenspezialisten"
"marine_class_sw_short"	"Waffenspez."
"marine_class_medic"	"Sanitäter"
"marine_class_tech"	"Techniker"
"marine_class_officer_label"	"Offiziere:"
"marine_class_sw_label"	"Waffenspezialisten:"
"marine_class_medic_label"	"Sanitäter:"
"marine_class_tech_label"	"Techniker:"
// achievements
"ASW_KILL_WITHOUT_FRIENDLY_FIRE_NAME"	"Feuer frei"
"ASW_NO_FRIENDLY_FIRE_NAME"	"Kontrollierte Feuerstöße"
"ASW_SHIELDBUG_NAME"	"Schilde heruntergefahren"
"ASW_GRENADE_MULTI_KILL_NAME"	"Explosionsradius"
"ASW_ACCURACY_NAME"	"Scharfschütze"
"ASW_NO_DAMAGE_TAKEN_NAME"	"Perfekt"
"ASW_EGGS_BEFORE_HATCH_NAME"	"Rührei"
"ASW_GRUB_KILLS_NAME"	"Raupenfeind"
"ASW_MELEE_PARASITE_NAME"	"Schädlingsbekämfpung"
"ASW_MELEE_KILLS_NAME"	"Haarscharf"
"ASW_BARREL_KILLS_NAME"	"Räuchertonnen"
"ASW_INFESTATION_CURING_NAME"	"Seuchen Heiland"
"ASW_FAST_WIRE_HACKS_NAME"	"Stromkreisunterbrecher"
"ASW_FAST_COMPUTER_HACKS_NAME"	"Sicherheitsexperte"
"ASW_GROUP_HEAL_NAME"	"Gruppenkuscheln"
"ASW_GROUP_DAMAGE_AMP_NAME"	"Schadensverstärkt"
"ASW_FAST_RELOADS_IN_A_ROW_NAME"	"Revolverheld"
"ASW_FAST_RELOAD_NAME"	"Schnelles Laden"
"ASW_ALL_HEALING_NAME"	"Friedensarzt"
"ASW_PROTECT_TECH_NAME"	"Schützt den Techniker!"
"ASW_TECH_SURVIVES_NAME"	"Techniker gesichert!"
"ASW_STUN_GRENADE_NAME"	"Gruppenschock"
"ASW_WELD_DOOR_NAME"	"Qualitätssiegel"
"ASW_DODGE_RANGER_SHOT_NAME"	"Unter Beschuss"
"ASW_BOOMER_KILL_EARLY_NAME"	"Schneller als der Tod"
"ASW_FREEZE_GRENADE_NAME"	"Bleib cool"
"ASW_AMMO_RESUPPLY_NAME"	"Nachschubtransporter"
"ASW_SENTRY_GUN_KILLS_NAME"	"Statischer Verteidiger"
"ASW_RIFLE_KILLS_NAME"	"Aerodynamiker"
"ASW_PRIFLE_KILLS_NAME"	"Professioneller Tester"
"ASW_AUTOGUN_KILLS_NAME"	"Kugelhagel-Experte"
"ASW_SHOTGUN_KILLS_NAME"	"Schrotflinten-Enthusiast"
"ASW_VINDICATOR_KILLS_NAME"	"Vindicator-Veteran"
"ASW_PISTOL_KILLS_NAME"	"Pistolen-Jongleur"
"ASW_PDW_KILLS_NAME"	"Spezialist für Kleinwaffen"
"ASW_TESLA_GUN_KILLS_NAME"	"Hochspannungstechniker"
"ASW_RAILGUN_KILLS_NAME"	"Schienenkanonier"
"ASW_FLAMER_KILLS_NAME"	"Pyrotechniker"
"ASW_CHAINSAW_KILLS_NAME"	"Schlächter"
"ASW_MINIGUN_KILLS_NAME"	"Minigun Meister"
"ASW_SNIPER_RIFLE_KILLS_NAME"	"Professioneller Scharfschütze"
"ASW_GRENADE_LAUNCHER_KILLS_NAME"	"Grenadier"
"ASW_COMBAT_RIFLE_KILLS_NAME"	"Kämpfer"
"ASW_DEAGLE_KILLS_NAME"	"Schreiender Adler"
"ASW_DEVASTATOR_KILLS_NAME"	"Am Boden zerstört"
"ASW_HORNET_KILLS_NAME"	"Der Raketenmann"
"ASW_LASER_MINE_KILLS_NAME"	"Sprengstoffexperte"
"ASW_MINE_KILLS_NAME"	"Firewall-Spezialist"
"ASW_UNLOCK_ALL_WEAPONS_NAME"	"Zugang zum Waffenlager"
"ASW_EASY_CAMPAIGN_NAME"	"Leicht: Jakobsruhe"
"ASW_NORMAL_CAMPAIGN_NAME"	"Normal: Jakobsruhe"
"ASW_HARD_CAMPAIGN_NAME"	"Schwer: Jakobsruhe"
"ASW_INSANE_CAMPAIGN_NAME"	"Wahnsinnig: Jakobsruhe"
"ASW_IMBA_CAMPAIGN_NAME"	"Brutal: Jakobsruhe"
"RD_EASY_CAMPAIGN_OCS_NAME"	"Leicht: Operation Säuberung"
"RD_NORMAL_CAMPAIGN_OCS_NAME"	"Normal: Operation Säuberung"
"RD_HARD_CAMPAIGN_OCS_NAME"	"Schwer: Operation Säuberung"
"RD_INSANE_CAMPAIGN_OCS_NAME"	"Wahnsinnig: Operation Säuberung"
"RD_IMBA_CAMPAIGN_OCS_NAME"	"Brutal: Operation Säuberung"
"RD_EASY_CAMPAIGN_RES_NAME"	"Leicht: Forschung 7"
"RD_NORMAL_CAMPAIGN_RES_NAME"	"Normal: Forschung 7"
"RD_HARD_CAMPAIGN_RES_NAME"	"Schwer: Forschung 7"
"RD_INSANE_CAMPAIGN_RES_NAME"	"Wahnsinnig: Forschung 7"
"RD_IMBA_CAMPAIGN_RES_NAME"	"Brutal: Forschung 7"
"RD_EASY_CAMPAIGN_AREA9800_NAME"	"Leicht: Bereich 9800"
"RD_NORMAL_CAMPAIGN_AREA9800_NAME"	"Normal: Bereich 9800"
"RD_HARD_CAMPAIGN_AREA9800_NAME"	"Schwer: Bereich 9800"
"RD_INSANE_CAMPAIGN_AREA9800_NAME"	"Wahnsinnig: Bereich 9800"
"RD_IMBA_CAMPAIGN_AREA9800_NAME"	"Brutal: Bereich 9800"
"RD_EASY_CAMPAIGN_TFT_NAME"	"Leicht: Tränen für Tanor"
"RD_NORMAL_CAMPAIGN_TFT_NAME"	"Normal: Tränen für Tanor"
"RD_HARD_CAMPAIGN_TFT_NAME"	"Schwer: Tränen für Tanor"
"RD_INSANE_CAMPAIGN_TFT_NAME"	"Wahnsinnig: Tränen für Tanor"
"RD_IMBA_CAMPAIGN_TFT_NAME"	"Brutal: Tränen für Tanor"
"RD_EASY_CAMPAIGN_DC_NAME"	"Leicht: Tote Stadt"
"RD_NORMAL_CAMPAIGN_DC_NAME"	"Normal: Tote Stadt"
"RD_HARD_CAMPAIGN_DC_NAME"	"Schwer: Tote Stadt"
"RD_INSANE_CAMPAIGN_DC_NAME"	"Wahnsinnig: Tote Stadt"
"RD_IMBA_CAMPAIGN_DC_NAME"	"Brutal: Tote Stadt"
"RD_EASY_CAMPAIGN_TIL_NAME"	"Leicht: Tilarus-5"
"RD_NORMAL_CAMPAIGN_TIL_NAME"	"Normal: Tilarus-5"
"RD_HARD_CAMPAIGN_TIL_NAME"	"Schwer: Tilarus-5"
"RD_INSANE_CAMPAIGN_TIL_NAME"	"Wahnsinnig: Tilarus-5"
"RD_IMBA_CAMPAIGN_TIL_NAME"	"Brutal: Tilarus-5"
"RD_EASY_CAMPAIGN_LAN_NAME"	"Leicht: Lanas Flucht"
"RD_NORMAL_CAMPAIGN_LAN_NAME"	"Normal: Lanas Flucht"
"RD_HARD_CAMPAIGN_LAN_NAME"	"Schwer: Lanas Flucht"
"RD_INSANE_CAMPAIGN_LAN_NAME"	"Wahnsinnig: Lanas Flucht"
"RD_IMBA_CAMPAIGN_LAN_NAME"	"Brutal: Lanas Flucht"
"RD_EASY_CAMPAIGN_REDUCTION_NAME"	"Leicht: Reduktion"
"RD_NORMAL_CAMPAIGN_REDUCTION_NAME"	"Normal: Reduktion"
"RD_HARD_CAMPAIGN_REDUCTION_NAME"	"Schwer: Reduktion"
"RD_INSANE_CAMPAIGN_REDUCTION_NAME"	"Wahnsinnig: Reduktion"
"RD_IMBA_CAMPAIGN_REDUCTION_NAME"	"Brutal: Reduktion"
"RD_EASY_CAMPAIGN_PAR_NAME"	"Leicht: Paranoia"
"RD_NORMAL_CAMPAIGN_PAR_NAME"	"Normal: Paranoia"
"RD_HARD_CAMPAIGN_PAR_NAME"	"Schwer: Paranoia"
"RD_INSANE_CAMPAIGN_PAR_NAME"	"Wahnsinnig: Paranoia"
"RD_IMBA_CAMPAIGN_PAR_NAME"	"Brutal: Paranoia"
"RD_EASY_CAMPAIGN_ORI_NAME"	"Leicht: Orions Bedrohung"
"RD_NORMAL_CAMPAIGN_ORI_NAME"	"Normal: Orions Bedrohung"
"RD_HARD_CAMPAIGN_ORI_NAME"	"Schwer: Orions Bedrohung"
"RD_INSANE_CAMPAIGN_ORI_NAME"	"Wahnsinnig: Orions Bedrohung"
"RD_IMBA_CAMPAIGN_ORI_NAME"	"Brutal: Orions Bedrohung"
"RD_EASY_CAMPAIGN_NH_NAME"	"Leicht: Nam Humanum"
"RD_NORMAL_CAMPAIGN_NH_NAME"	"Normal: Nam Humanum"
"RD_HARD_CAMPAIGN_NH_NAME"	"Schwer: Nam Humanum"
"RD_INSANE_CAMPAIGN_NH_NAME"	"Wahnsinnig: Nam Humanum"
"RD_IMBA_CAMPAIGN_NH_NAME"	"Brutal: Nam Humanum"
"RD_EASY_CAMPAIGN_BIO_NAME"	"Leicht: BioGen Gesellschaft"
"RD_NORMAL_CAMPAIGN_BIO_NAME"	"Normal: BioGen Gesellschaft"
"RD_HARD_CAMPAIGN_BIO_NAME"	"Schwer: BioGen Gesellschaft"
"RD_INSANE_CAMPAIGN_BIO_NAME"	"Wahnsinnig: BioGen Gesellschaft"
"RD_IMBA_CAMPAIGN_BIO_NAME"	"Brutal: BioGen Gesellschaft"
"ASW_HARDCORE_NAME"	"Hardcore"
"ASW_KILL_GRIND_1_NAME"	"Auf der Bereitschaftslinie"
"ASW_KILL_GRIND_2_NAME"	"Eine weitere Jagd"
"ASW_KILL_GRIND_3_NAME"	"Tötet sie alle"
"ASW_KILL_GRIND_4_NAME"	"Orbitaler Nuklearangriff"
"ASW_SPEEDRUN_LANDING_BAY_NAME"	"Speedrun: Landungsbucht"
"ASW_SPEEDRUN_DESCENT_NAME"	"Speedrun: Lastenaufzug"
"ASW_SPEEDRUN_DEIMA_NAME"	"Speedrun: Deima Brücke"
"ASW_SPEEDRUN_RYDBERG_NAME"	"Speedrun: Rydberg Reaktor"
"ASW_SPEEDRUN_RESIDENTIAL_NAME"	"Speedrun: SynTek Wohnareal"
"ASW_SPEEDRUN_SEWER_NAME"	"Speedrun: Abwasseranlage"
"ASW_SPEEDRUN_TIMOR_NAME"	"Speedrun: Timor Station"
"RD_SPEEDRUN_OCS_STORAGE_FACILITY_NAME"	"Speedrun: Lagereinrichtung"
"RD_SPEEDRUN_OCS_LANDING_BAY_7_NAME"	"Speedrun: Landebucht 7"
"RD_SPEEDRUN_OCS_USC_MEDUSA_NAME"	"Speedrun: U.S.C. Medusa"
"RD_SPEEDRUN_RES_FOREST_ENTRANCE_NAME"	"Speedrun: Transporteinrichtung"
"RD_SPEEDRUN_RES_RESEARCH_7_NAME"	"Speedrun: Forschung 7"
"RD_SPEEDRUN_RES_MINING_CAMP_NAME"	"Speedrun: Illyn Wald"
"RD_SPEEDRUN_RES_MINES_NAME"	"Speedrun: Jericho Minen"
"RD_SPEEDRUN_AREA9800_LZ_NAME"	"Speedrun: Landezone"
"RD_SPEEDRUN_AREA9800_PP1_NAME"	"Speedrun: Kühlpumpe"
"RD_SPEEDRUN_AREA9800_PP2_NAME"	"Speedrun: Stromgenerator"
"RD_SPEEDRUN_AREA9800_WL_NAME"	"Speedrun: Ödland"
"RD_SPEEDRUN_TFT_DESERT_OUTPOST_NAME"	"Speedrun: Eintrittsstelle"
"RD_SPEEDRUN_TFT_ABANDONED_MAINTENANCE_NAME"	"Speedrun: Verlassene Wartungstunnel"
"RD_SPEEDRUN_TFT_SPACEPORT_NAME"	"Speedrun: Oasis-Kolonie Raumhafen"
"RD_SPEEDRUN_DC_OMEGA_CITY_NAME"	"Speedrun: Omega City"
"RD_SPEEDRUN_DC_BREAKING_AN_ENTRY_NAME"	"Speedrun: Einbruch"
"RD_SPEEDRUN_DC_SEARCH_AND_RESCUE_NAME"	"Speedrun: Suche und Rettung"
"RD_SPEEDRUN_TIL_MIDNIGHT_PORT_NAME"	"Speedrun: Mitternachtshafen"
"RD_SPEEDRUN_TIL_ROAD_TO_DAWN_NAME"	"Speedrun: Weg zur Dämmerung"
"RD_SPEEDRUN_TIL_ARCTIC_INFILTRATION_NAME"	"Speedrun: Arktische Infiltration"
"RD_SPEEDRUN_TIL_AREA9800_NAME"	"Speedrun: Bereich 9800 Landezone"
"RD_SPEEDRUN_TIL_COLD_CATWALKS_NAME"	"Speedrun: Kalte Laufstege"
"RD_SPEEDRUN_TIL_YANAURUS_MINE_NAME"	"Speedrun: Yanaurus Mine"
"RD_SPEEDRUN_TIL_FACTORY_NAME"	"Speedrun: Die Fabrik"
"RD_SPEEDRUN_TIL_COM_CENTER_NAME"	"Speedrun: Kommunikationszentrum"
"RD_SPEEDRUN_TIL_SYNTEK_HOSPITAL_NAME"	"Speedrun: SynTek Krankenhaus"
"RD_SPEEDRUN_LAN_BRIDGE_NAME"	"Speedrun: Lanas Brücke"
"RD_SPEEDRUN_LAN_SEWER_NAME"	"Speedrun: Lanas Kanalisation"
"RD_SPEEDRUN_LAN_MAINTENANCE_NAME"	"Speedrun: Lanas Wartung"
"RD_SPEEDRUN_LAN_VENT_NAME"	"Speedrun: Lanas Schächte"
"RD_SPEEDRUN_LAN_COMPLEX_NAME"	"Speedrun: Lanas Komplex"
"RD_SPEEDRUN_REDUCTION_1_NAME"	"Speedrun: Einsatz 1"
"RD_SPEEDRUN_REDUCTION_2_NAME"	"Speedrun: Einsatz 2"
"RD_SPEEDRUN_REDUCTION_3_NAME"	"Speedrun: Einsatz 3"
"RD_SPEEDRUN_REDUCTION_4_NAME"	"Speedrun: Einsatz 4"
"RD_SPEEDRUN_REDUCTION_5_NAME"	"Speedrun: Einsatz 5"
"RD_SPEEDRUN_REDUCTION_6_NAME"	"Speedrun: Einsatz 6"
"RD_SPEEDRUN_PAR_UNEXPECTED_ENCOUNTER_NAME"	"Speedrun: Unerwartete Begegnung"
"RD_SPEEDRUN_PAR_HOSTILE_PLACES_NAME"	"Speedrun: Feindliche Orte"
"RD_SPEEDRUN_PAR_CLOSE_CONTACT_NAME"	"Speedrun: Enger Kontakt"
"RD_SPEEDRUN_PAR_HIGH_TENSION_NAME"	"Speedrun: Hochspannung"
"RD_SPEEDRUN_PAR_CRUCIAL_POINT_NAME"	"Speedrun: Entscheidender Punkt"
"RD_SPEEDRUN_ORI_REFINERY_NAME"	"Speedrun: Niosa Raffinerie"
"RD_SPEEDRUN_ORI_ANOMALY_NAME"	"Speedrun: Erste Anomalie"
"RD_SPEEDRUN_NH_LOGISTICS_AREA_NAME"	"Speedrun: Logistikgebiet"
"RD_SPEEDRUN_NH_PLATFORM_XVII_NAME"	"Speedrun: Plattform XVII"
"RD_SPEEDRUN_NH_GROUNDWORK_LABS_NAME"	"Speedrun: Grundstein Laboratorien"
"RD_SPEEDRUN_BIO_OPERATION_X5_NAME"	"Speedrun: Operation x5"
"RD_SPEEDRUN_BIO_INVISIBLE_THREAT_NAME"	"Speedrun: Unsichtbare Bedrohung"
"RD_SPEEDRUN_BIO_BIOGEN_LABS_NAME"	"Speedrun: BioGen Labore"
"ASW_CAMPAIGN_NO_DEATHS_NAME"	"Herausragend: Jakobsruhe"
"RD_CAMPAIGN_NO_DEATHS_OCS_NAME"	"Herausragend: Operation Säuberung"
"RD_CAMPAIGN_NO_DEATHS_RES_NAME"	"Herausragend: Forschung 7"
"RD_CAMPAIGN_NO_DEATHS_AREA9800_NAME"	"Herausragend: Bereich 9800"
"RD_CAMPAIGN_NO_DEATHS_TFT_NAME"	"Herausragend: Tränen für Tanor"
"RD_CAMPAIGN_NO_DEATHS_DC_NAME"	"Herausragend: Tote Stadt"
"RD_CAMPAIGN_NO_DEATHS_TIL_NAME"	"Herausragend: Tilarus-5"
"RD_CAMPAIGN_NO_DEATHS_LAN_NAME"	"Herausragend: Lanas Flucht"
"RD_CAMPAIGN_NO_DEATHS_REDUCTION_NAME"	"Herausragend: Reduktion"
"RD_CAMPAIGN_NO_DEATHS_PAR_NAME"	"Herausragend: Paranoia"
"RD_CAMPAIGN_NO_DEATHS_ORI_NAME"	"Herausragend: Orions Bedrohung"
"RD_CAMPAIGN_NO_DEATHS_NH_NAME"	"Herausragend: Nam Humanum"
"RD_CAMPAIGN_NO_DEATHS_BIO_NAME"	"Herausragend: BioGen Gesellschaft"
"ASW_MISSION_NO_DEATHS_NAME"	"Unsterblichkeit"
"RD_GAS_GRENADE_KILLS_NAME"	"Chemische Kriegsführung"
"RD_HEAVY_RIFLE_KILLS_NAME"	"Spezialist für schwere Angriffe"
"RD_MEDICAL_SMG_KILLS_NAME"	"Kampfsanitäter"
"RD_NH_BONUS_OBJECTIVE_NAME"	"Die Entscheidung für den Fortschritt"
"ASW_KILL_WITHOUT_FRIENDLY_FIRE_DESC"	"Töte 25 Aliens ohne Freundbeschuss, mit mindestens 4 Soldaten im Einsatz."
"ASW_NO_FRIENDLY_FIRE_DESC"	"Beende einen Einsatz ohne Freundbeschuss, mit mindestens 4 Soldaten im Einsatz."
"ASW_SHIELDBUG_DESC"	"Gib einem Schildkäfer den Todesstoß."
"ASW_GRENADE_MULTI_KILL_DESC"	"Töte 6 Aliens mit einer einzigen Granate."
"ASW_ACCURACY_DESC"	"Schließe einen Einsatz mit einer Zielgenauigkeit von mehr als 90% ab."
"ASW_NO_DAMAGE_TAKEN_DESC"	"Schließe einen Einsatz auf Normal ab, ohne Schaden zu nehmen."
"ASW_EGGS_BEFORE_HATCH_DESC"	"Zerstöre alle Alien-Eier bei einem Einsatz, ohne dass eines schlüpft."
"ASW_GRUB_KILLS_DESC"	"Zertrete 100 Raupen."
"ASW_MELEE_PARASITE_DESC"	"Töte einen Parasiten mit einem Nahkampfangriff."
"ASW_MELEE_KILLS_DESC"	"Töte 20 Aliens mit Nahkampfangriffen bei einem einzigen Einsatz."
"ASW_BARREL_KILLS_DESC"	"Töte 5 Aliens mit explosiven Fässern bei einem einzigen Einsatz."
"ASW_INFESTATION_CURING_DESC"	"Heile einen befallenen Soldaten."
"ASW_FAST_WIRE_HACKS_DESC"	"Schließe 10 Kabelhacks ab, ohne dass der Zugriff protokolliert wird."
"ASW_FAST_COMPUTER_HACKS_DESC"	"Hacke 10 Computer, ohne dass der Zugriff protokolliert wird."
"ASW_GROUP_HEAL_DESC"	"Heile mindestens 4 Soldaten mit einem einzigen Heilkreis."
"ASW_GROUP_DAMAGE_AMP_DESC"	"Töte 15 Aliens mit mindesten 4 Soldaten unter der Wirkung einer Schadensverstärkung bei einem einzigen Einsatz."
"ASW_FAST_RELOADS_IN_A_ROW_DESC"	"Schnelllade 5 mal in Folge erfolgreich deine Waffe."
"ASW_FAST_RELOAD_DESC"	"Führe eine Schnellladung deiner Waffe durch."
"ASW_ALL_HEALING_DESC"	"Heile 300 Punkte Schaden bei einem Einsatz ohne Aliens mehr als Nahkampfschaden zuzufügen."
"ASW_PROTECT_TECH_DESC"	"Beschütze einen Techniker während seinem Hack."
"ASW_TECH_SURVIVES_DESC"	"Schließe einen Einsatz ab, ohne dass der Techniker getötet wird."
"ASW_STUN_GRENADE_DESC"	"Betäube 6 Aliens mit einer einzigen Elektroschock-Granate."
"ASW_WELD_DOOR_DESC"	"Versiegle eine Tür mit dem Schweißgerät."
"ASW_DODGE_RANGER_SHOT_DESC"	"Rolle unter einem Alien-Projektil hindurch."
"ASW_BOOMER_KILL_EARLY_DESC"	"Töte einen Boomer, bevor er sich aufbläst."
"ASW_FREEZE_GRENADE_DESC"	"Stoppe 6 Aliens mit einer einzigen Frost-Granate."
"ASW_AMMO_RESUPPLY_DESC"	"Stelle 10 Munitionslager auf, die von anderen Soldaten genutzt werden."
"ASW_SENTRY_GUN_KILLS_DESC"	"Töte 500 Aliens mit aufstellbaren Wächtern."
"ASW_RIFLE_KILLS_DESC"	"Töte 250 Aliens mit dem Sturmgewehr."
"ASW_PRIFLE_KILLS_DESC"	"Töte 250 Aliens mit dem Prototyp-Gewehr."
"ASW_AUTOGUN_KILLS_DESC"	"Töte 250 Aliens mit der Autogun."
"ASW_SHOTGUN_KILLS_DESC"	"Töte 250 Aliens mit der Schrotflinte."
"ASW_VINDICATOR_KILLS_DESC"	"Töte 250 Aliens mit dem Vindicator."
"ASW_PISTOL_KILLS_DESC"	"Töte 250 Aliens mit den Pistolen."
"ASW_PDW_KILLS_DESC"	"Töte 250 Aliens mit den PDWs."
"ASW_TESLA_GUN_KILLS_DESC"	"Töte 250 Aliens mit der Tesla-Kanone."
"ASW_RAILGUN_KILLS_DESC"	"Töte 250 Aliens mit dem Schienengewehr."
"ASW_FLAMER_KILLS_DESC"	"Töte 250 Aliens mit dem Flammenwerfer."
"ASW_CHAINSAW_KILLS_DESC"	"Töte 250 Aliens mit der Kettensäge."
"ASW_MINIGUN_KILLS_DESC"	"Töte 250 Aliens mit der Minigun."
"ASW_SNIPER_RIFLE_KILLS_DESC"	"Töte 250 Aliens mit dem Scharfschützengewehr."
"ASW_GRENADE_LAUNCHER_KILLS_DESC"	"Töte 250 Aliens mit dem Granatwerfer."
"ASW_COMBAT_RIFLE_KILLS_DESC"	"Töte 250 Aliens mit dem Kampfgewehr."
"ASW_DEAGLE_KILLS_DESC"	"Töte 250 Aliens mit der Desert Eagle."
"ASW_DEVASTATOR_KILLS_DESC"	"Töte 250 Aliens mit dem Devastator."
"ASW_HORNET_KILLS_DESC"	"Töten Sie 100 Aliens mit Raketen-Sperrfeuer."
"ASW_LASER_MINE_KILLS_DESC"	"Töten Sie 100 Aliens mit Haftminen."
"ASW_MINE_KILLS_DESC"	"Töten Sie 100 Aliens mit Brandminen."
"ASW_UNLOCK_ALL_WEAPONS_DESC"	"Schalten Sie alle verfügbaren Waffen frei."
"ASW_EASY_CAMPAIGN_DESC"	"Beende den Feldzug \"Jakobsruhe\" auf Leicht."
"ASW_NORMAL_CAMPAIGN_DESC"	"Beende den Feldzug \"Jakobsruhe\" auf Normal."
"ASW_HARD_CAMPAIGN_DESC"	"Beende den Feldzug \"Jakobsruhe\" auf Schwer."
"ASW_INSANE_CAMPAIGN_DESC"	"Beende den Feldzug \"Jakobsruhe\" auf Wahnsinnig."
"ASW_IMBA_CAMPAIGN_DESC"	"Beende den Feldzug \"Jakobsruhe\" auf Brutal."
"RD_EASY_CAMPAIGN_OCS_DESC"	"Beende den Feldzug \"Operation Säuberung\" auf Leicht."
"RD_NORMAL_CAMPAIGN_OCS_DESC"	"Beende den Feldzug \"Operation Säuberung\" auf Normal."
"RD_HARD_CAMPAIGN_OCS_DESC"	"Beende den Feldzug \"Operation Säuberung\" auf Schwer."
"RD_INSANE_CAMPAIGN_OCS_DESC"	"Beende den Feldzug \"Operation Säuberung\" auf Wahnsinnig."
"RD_IMBA_CAMPAIGN_OCS_DESC"	"Beende den Feldzug \"Operation Säuberung\" auf Brutal."
"RD_EASY_CAMPAIGN_RES_DESC"	"Beende den Feldzug \"Forschung 7\" auf Leicht."
"RD_NORMAL_CAMPAIGN_RES_DESC"	"Beende den Feldzug \"Forschung 7\" auf Normal."
"RD_HARD_CAMPAIGN_RES_DESC"	"Beende den Feldzug \"Forschung 7\" auf Schwer."
"RD_INSANE_CAMPAIGN_RES_DESC"	"Beende den Feldzug \"Forschung 7\" auf Wahnsinnig."
"RD_IMBA_CAMPAIGN_RES_DESC"	"Beende den Feldzug \"Forschung 7\" auf Brutal."
"RD_EASY_CAMPAIGN_AREA9800_DESC"	"Beende den Feldzug \"Bereich 9800\" auf Leicht."
"RD_NORMAL_CAMPAIGN_AREA9800_DESC"	"Beende den Feldzug \"Bereich 9800\" auf Normal."
"RD_HARD_CAMPAIGN_AREA9800_DESC"	"Beende den Feldzug \"Bereich 9800\" auf Schwer."
"RD_INSANE_CAMPAIGN_AREA9800_DESC"	"Beende den Feldzug \"Bereich 9800\" auf Wahnsinnig."
"RD_IMBA_CAMPAIGN_AREA9800_DESC"	"Beende den Feldzug \"Bereich 9800\" auf Brutal."
"RD_EASY_CAMPAIGN_TFT_DESC"	"Beende den Feldzug \"Tränen für Tanor\" auf Leicht."
"RD_NORMAL_CAMPAIGN_TFT_DESC"	"Beende den Feldzug \"Tränen für Tanor\" auf Normal."
"RD_HARD_CAMPAIGN_TFT_DESC"	"Beende den Feldzug \"Tränen für Tanor\" auf Schwer."
"RD_INSANE_CAMPAIGN_TFT_DESC"	"Beende den Feldzug \"Tränen für Tanor\" auf Wahnsinnig."
"RD_IMBA_CAMPAIGN_TFT_DESC"	"Beende den Feldzug \"Tränen für Tanor\" auf Brutal."
"RD_EASY_CAMPAIGN_DC_DESC"	"Beende den Feldzug \"Tote Stadt\" auf Leicht."
"RD_NORMAL_CAMPAIGN_DC_DESC"	"Beende den Feldzug \"Tote Stadt\" auf Normal."
"RD_HARD_CAMPAIGN_DC_DESC"	"Beende den Feldzug \"Tote Stadt\" auf Schwer."
"RD_INSANE_CAMPAIGN_DC_DESC"	"Beende den Feldzug \"Tote Stadt\" auf Wahnsinnig."
"RD_IMBA_CAMPAIGN_DC_DESC"	"Beende den Feldzug \"Tote Stadt\" auf Brutal."
"RD_EASY_CAMPAIGN_TIL_DESC"	"Beende den Feldzug \"Tilarus-5\" auf Leicht."
"RD_NORMAL_CAMPAIGN_TIL_DESC"	"Beende den Feldzug \"Tilarus-5\" auf Normal."
"RD_HARD_CAMPAIGN_TIL_DESC"	"Beende den Feldzug \"Tilarus-5\" auf Schwer."
"RD_INSANE_CAMPAIGN_TIL_DESC"	"Beende den Feldzug \"Tilarus-5\" auf Wahnsinnig."
"RD_IMBA_CAMPAIGN_TIL_DESC"	"Beende den Feldzug \"Tilarus-5\" auf Brutal."
"RD_EASY_CAMPAIGN_LAN_DESC"	"Beende den Feldzug \"Lanas Flucht\" auf Leicht."
"RD_NORMAL_CAMPAIGN_LAN_DESC"	"Beende den Feldzug \"Lanas Flucht\" auf Normal."
"RD_HARD_CAMPAIGN_LAN_DESC"	"Beende den Feldzug \"Lanas Flucht\" auf Schwer."
"RD_INSANE_CAMPAIGN_LAN_DESC"	"Beende den Feldzug \"Lanas Flucht\" auf Wahnsinnig."
"RD_IMBA_CAMPAIGN_LAN_DESC"	"Beende den Feldzug \"Lanas Flucht\" auf Brutal."
"RD_EASY_CAMPAIGN_REDUCTION_DESC"	"Beende den Feldzug \"Reduktion\" auf Leicht."
"RD_NORMAL_CAMPAIGN_REDUCTION_DESC"	"Beende den Feldzug \"Reduktion\" auf Normal."
"RD_HARD_CAMPAIGN_REDUCTION_DESC"	"Beende den Feldzug \"Reduktion\" auf Schwer."
"RD_INSANE_CAMPAIGN_REDUCTION_DESC"	"Beende den Feldzug \"Reduktion\" auf Wahnsinnig."
"RD_IMBA_CAMPAIGN_REDUCTION_DESC"	"Beende den Feldzug \"Reduktion\" auf Brutal."
"RD_EASY_CAMPAIGN_PAR_DESC"	"Beende den Feldzug \"Paranoia\" auf Leicht."
"RD_NORMAL_CAMPAIGN_PAR_DESC"	"Beende den Feldzug \"Paranoia\" auf Normal."
"RD_HARD_CAMPAIGN_PAR_DESC"	"Beende den Feldzug \"Paranoia\" auf Schwer."
"RD_INSANE_CAMPAIGN_PAR_DESC"	"Beende den Feldzug \"Paranoia\" auf Wahnsinnig."
"RD_IMBA_CAMPAIGN_PAR_DESC"	"Beende den Feldzug \"Paranoia\" auf Brutal."
"RD_EASY_CAMPAIGN_ORI_DESC"	"Beende den Feldzug \"Orions Bedrohung\" auf Leicht."
"RD_NORMAL_CAMPAIGN_ORI_DESC"	"Beende den Feldzug \"Orions Bedrohung\" auf Normal."
"RD_HARD_CAMPAIGN_ORI_DESC"	"Beende den Feldzug \"Orions Bedrohung\" auf Schwer."
"RD_INSANE_CAMPAIGN_ORI_DESC"	"Beende den Feldzug \"Orions Bedrohung\" auf Wahnsinnig."
"RD_IMBA_CAMPAIGN_ORI_DESC"	"Beende den Feldzug \"Orions Bedrohung\" auf Brutal."
"RD_EASY_CAMPAIGN_NH_DESC"	"Beende den Feldzug \"Nam Humanum\" auf Leicht."
"RD_NORMAL_CAMPAIGN_NH_DESC"	"Beende den Feldzug \"Nam Humanum\" auf Normal."
"RD_HARD_CAMPAIGN_NH_DESC"	"Beende den Feldzug \"Nam Humanum\" auf Schwer."
"RD_INSANE_CAMPAIGN_NH_DESC"	"Beende den Feldzug \"Nam Humanum\" auf Wahnsinnig."
"RD_IMBA_CAMPAIGN_NH_DESC"	"Beende den Feldzug \"Nam Humanum\" auf Brutal."
"RD_EASY_CAMPAIGN_BIO_DESC"	"Beende den Feldzug \"BioGen Gesellschaft\" auf Leicht."
"RD_NORMAL_CAMPAIGN_BIO_DESC"	"Beende den Feldzug \"BioGen Gesellschaft\" auf Normal."
"RD_HARD_CAMPAIGN_BIO_DESC"	"Beende den Feldzug \"BioGen Gesellschaft\" auf Schwer."
"RD_INSANE_CAMPAIGN_BIO_DESC"	"Beende den Feldzug \"BioGen Gesellschaft\" auf Wahnsinnig."
"RD_IMBA_CAMPAIGN_BIO_DESC"	"Beende den Feldzug \"BioGen Gesellschaft\" auf Brutal."
"ASW_HARDCORE_DESC"	"Schließe einen Einsatz auf Brutal mit aktiviertem \"Ansturm\" und \"Hardcore-Freundbeschuss\" ab."
"ASW_KILL_GRIND_1_DESC"	"Töte 1.000 Aliens."
"ASW_KILL_GRIND_2_DESC"	"Töte 5.000 Aliens."
"ASW_KILL_GRIND_3_DESC"	"Töte 25.000 Aliens."
"ASW_KILL_GRIND_4_DESC"	"Töte 100.000 Aliens."
"ASW_SPEEDRUN_LANDING_BAY_DESC"	"Schließe den Einsatz \"Landungsbucht\" innerhalb von 1:25 auf Normal ab, ohne Verluste."
"ASW_SPEEDRUN_DESCENT_DESC"	"Schließe den Einsatz \"Lastenaufzug\" innerhalb von 2:50 auf Normal ab, ohne Verluste."
"ASW_SPEEDRUN_DEIMA_DESC"	"Schließe den Einsatz \"Deima Brücke\" innerhalb von 2:30 auf Normal ab, ohne Verluste."
"ASW_SPEEDRUN_RYDBERG_DESC"	"Schließe den Einsatz \"Rydberg Reaktor\" innerhalb von 3:10 auf Normal ab, ohne Verluste."
"ASW_SPEEDRUN_RESIDENTIAL_DESC"	"Schließe den Einsatz \"SynTek Wohnareal\" innerhalb von 2:30 auf Normal ab, ohne Verluste."
"ASW_SPEEDRUN_SEWER_DESC"	"Schließe den Einsatz \"Abwasseranlage\" innerhalb von 1:30 auf Normal ab, ohne Verluste."
"ASW_SPEEDRUN_TIMOR_DESC"	"Schließe den Einsatz \"Timor Station\" innerhalb von 4:25 auf Normal ab, ohne Verluste."
"RD_SPEEDRUN_OCS_STORAGE_FACILITY_DESC"	"Schließe den Einsatz \"Lagereinrichtung\" innerhalb von 1:05 auf Normal ab, ohne Verluste."
"RD_SPEEDRUN_OCS_LANDING_BAY_7_DESC"	"Schließe den Einsatz \"Landebucht 7\" innerhalb von 1:30 auf Normal ab, ohne Verluste."
"RD_SPEEDRUN_OCS_USC_MEDUSA_DESC"	"Schließe den Einsatz \"U.S.C. Medusa\" innerhalb von 2:45 auf Normal ab, ohne Verluste."
"RD_SPEEDRUN_RES_FOREST_ENTRANCE_DESC"	"Schließe den Einsatz \"Transporteinrichtung\" innerhalb von 1:45 auf Normal ab, ohne Verluste."
"RD_SPEEDRUN_RES_RESEARCH_7_DESC"	"Schließe den Einsatz \"Forschung 7\" innerhalb von 2:30 auf Normal ab, ohne Verluste."
"RD_SPEEDRUN_RES_MINING_CAMP_DESC"	"Schließe den Einsatz \"Illyn Wald\" innerhalb von 3:40 auf Normal ab, ohne Verluste."
"RD_SPEEDRUN_RES_MINES_DESC"	"Schließe den Einsatz \"Jericho Minen\" innerhalb von 3:30 auf Normal ab, ohne Verluste."
"RD_SPEEDRUN_AREA9800_LZ_DESC"	"Schließe den Einsatz \"Landezone\" innerhalb von 2:35 auf Normal ab, ohne Verluste."
"RD_SPEEDRUN_AREA9800_PP1_DESC"	"Schließe den Einsatz \"Kühlpumpe\" innerhalb von 2:05 auf Normal ab, ohne Verluste."
"RD_SPEEDRUN_AREA9800_PP2_DESC"	"Schließe den Einsatz \"Stromgenerator\" innerhalb von 2:25 auf Normal ab, ohne Verluste."
"RD_SPEEDRUN_AREA9800_WL_DESC"	"Schließe den Einsatz \"Ödland\" innerhalb von 1:35 auf Normal ab, ohne Verluste."
"RD_SPEEDRUN_TFT_DESERT_OUTPOST_DESC"	"Schließe den Einsatz \"Eintrittsstelle\" innerhalb von 2:48 auf Normal, ohne Verluste."
"RD_SPEEDRUN_TFT_ABANDONED_MAINTENANCE_DESC"	"Schließe den Einsatz \"Verlassene Wartungstunnel\" innerhalb von 2:22 auf Normal, ohne Verluste."
"RD_SPEEDRUN_TFT_SPACEPORT_DESC"	"Schließe den Einsatz \"Oasis-Kolonie Raumhafen\" innerhalb von 4:24 auf Normal, ohne Verluste."
"RD_SPEEDRUN_DC_OMEGA_CITY_DESC"	"Schließe den Einsatz \"Omega City\" innerhalb von 5:00 auf Normal, ohne Verluste."
"RD_SPEEDRUN_DC_BREAKING_AN_ENTRY_DESC"	"Schließe den Einsatz \"Einbruch\" innerhalb von 4:00 auf Normal, ohne Verluste."
"RD_SPEEDRUN_DC_SEARCH_AND_RESCUE_DESC"	"Schließe den Einsatz \"Suche und Rettung\" innerhalb von 6:30 auf Normal, ohne Verluste."
"RD_SPEEDRUN_TIL_MIDNIGHT_PORT_DESC"	"Schließe den Einsatz \"Mitternachtshafen\" innerhalb von 2:25 auf Normal ab, ohne Verluste."
"RD_SPEEDRUN_TIL_ROAD_TO_DAWN_DESC"	"Schließe den Einsatz \"Weg zur Dämmerung\" innerhalb von 4:08 auf Normal ab, ohne Verluste."
"RD_SPEEDRUN_TIL_ARCTIC_INFILTRATION_DESC"	"Schließe den Einsatz \"Arktische Infiltration\" innerhalb von 2:12 auf Normal ab, ohne Verluste."
"RD_SPEEDRUN_TIL_AREA9800_DESC"	"Schließe den Einsatz \"Bereich 9800 Landezone\" innerhalb von 2:28 auf Normal ab, ohne Verluste."
"RD_SPEEDRUN_TIL_COLD_CATWALKS_DESC"	"Schließe den Einsatz \"Kalte Laufstege\" innerhalb von 2:10 auf Normal ab, ohne Verluste."
"RD_SPEEDRUN_TIL_YANAURUS_MINE_DESC"	"Schließe den Einsatz \"Yanaurus Mine\" innerhalb von 3:23 auf Normal ab, ohne Verluste."
"RD_SPEEDRUN_TIL_FACTORY_DESC"	"Schließe den Einsatz \"Die Fabrik\" innerhalb von 3:30 Minuten auf Normal ab, ohne Verluste."
"RD_SPEEDRUN_TIL_COM_CENTER_DESC"	"Schließe den Einsatz \"Kommunikationszentrum\" innerhalb von 3:21 auf Normal ab, ohne Verluste."
"RD_SPEEDRUN_TIL_SYNTEK_HOSPITAL_DESC"	"Schließe den Einsatz \"SynTek Krankenhaus\" innerhalb von 2:42 auf Normal ab, ohne Verluste."
"RD_SPEEDRUN_LAN_BRIDGE_DESC"	"Schließe den Einsatz \"Lanas Brücke\" innerhalb von 2:37 auf Normal ab, ohne Verluste."
"RD_SPEEDRUN_LAN_SEWER_DESC"	"Schließe den Einsatz \"Lanas Kanalisation\" innerhalb von 2:25 auf Normal ab, ohne Verluste."
"RD_SPEEDRUN_LAN_MAINTENANCE_DESC"	"Schließe den Einsatz \"Lanas Wartung\" innerhalb von 2:16 auf Normal ab, ohne Verluste."
"RD_SPEEDRUN_LAN_VENT_DESC"	"Schließe den Einsatz \"Lanas Schächte\" innerhalb von 2:48 auf Normal ab, ohne Verluste."
"RD_SPEEDRUN_LAN_COMPLEX_DESC"	"Schließe den Einsatz \"Lanas Komplex\" innerhalb von 4:48 auf Normal ab, ohne Verluste."
"RD_SPEEDRUN_REDUCTION_1_DESC"	"Schließe den Einsatz 1 innerhalb von [minutes:seconds] auf Normal ab, ohne Verluste."
"RD_SPEEDRUN_REDUCTION_2_DESC"	"Schließe den Einsatz 2 innerhalb von [minutes:seconds] auf Normal ab, ohne Verluste."
"RD_SPEEDRUN_REDUCTION_3_DESC"	"Schließe den Einsatz 3 innerhalb von [minutes:seconds] auf Normal ab, ohne Verluste."
"RD_SPEEDRUN_REDUCTION_4_DESC"	"Schließe den Einsatz 4 innerhalb von [minutes:seconds] auf Normal ab, ohne Verluste."
"RD_SPEEDRUN_REDUCTION_5_DESC"	"Schließe den Einsatz 5 innerhalb von [minutes:seconds] auf Normal ab, ohne Verluste."
"RD_SPEEDRUN_REDUCTION_6_DESC"	"Schließe den Einsatz 6 innerhalb von [minutes:seconds] auf Normal ab, ohne Verluste."
"RD_SPEEDRUN_PAR_UNEXPECTED_ENCOUNTER_DESC"	"Schließe den Einsatz \"Unerwartete Begegnung\" innerhalb von 1:05 auf Normal ab, ohne Verluste."
"RD_SPEEDRUN_PAR_HOSTILE_PLACES_DESC"	"Schließe den Einsatz \"Feindliche Orte\" innerhalb von 1:20 auf Normal ab, ohne Verluste."
"RD_SPEEDRUN_PAR_CLOSE_CONTACT_DESC"	"Schließe den Einsatz \"Enger Kontakt\" innerhalb von 1:10 auf Normal ab, ohne Verluste."
"RD_SPEEDRUN_PAR_HIGH_TENSION_DESC"	"Schließe den Einsatz \"Hochspannung\" innerhalb von 3:50 auf Normal ab, ohne Verluste."
"RD_SPEEDRUN_PAR_CRUCIAL_POINT_DESC"	"Schließe den Einsatz \"Entscheidender Punkt\" innerhalb von 3:00 auf Normal ab, ohne Verluste."
"RD_SPEEDRUN_ORI_REFINERY_DESC"	"Schließe den Einsatz \"Niosa Raffinerie\" innerhalb von 3:22 auf Normal ab, ohne Verluste."
"RD_SPEEDRUN_ORI_ANOMALY_DESC"	"Schließe den Einsatz \"Erste Anomalie\" innerhalb von 3:00 auf Normal ab, ohne Verluste."
"RD_SPEEDRUN_NH_LOGISTICS_AREA_DESC"	"Schließe den Einsatz \"Logistikgebiet\" innerhalb von 1:10 auf Normal ab, ohne Verluste."
"RD_SPEEDRUN_NH_PLATFORM_XVII_DESC"	"Schließe den Einsatz \"Plattform XVII\" innerhalb von 3:02 auf Normal ab, ohne Verluste."
"RD_SPEEDRUN_NH_GROUNDWORK_LABS_DESC"	"Schließe den Einsatz \"Grundstein Laboratorien\" innerhalb von 2:25 auf Normal ab, ohne Verluste."
"RD_SPEEDRUN_BIO_OPERATION_X5_DESC"	"Schließe den Einsatz \"Operation x5\" innerhalb von 3:28 auf Normal ab, ohne Verluste."
"RD_SPEEDRUN_BIO_INVISIBLE_THREAT_DESC"	"Schließe den Einsatz \"Unsichtbare Bedrohung\" innerhalb von 1:13 auf Normal ab, ohne Verluste."
"RD_SPEEDRUN_BIO_BIOGEN_LABS_DESC"	"Schließe den Einsatz \"BioGen Labore\" innerhalb von 4:14 auf Normal ab, ohne Verluste."
"ASW_CAMPAIGN_NO_DEATHS_DESC"	"Beende den Feldzug \"Jakobsruhe\" auf Normal, ohne Verluste."
"RD_CAMPAIGN_NO_DEATHS_OCS_DESC"	"Beende den Feldzug \"Operation Säuberung\" auf Normal, ohne Verluste."
"RD_CAMPAIGN_NO_DEATHS_RES_DESC"	"Beende den Feldzug \"Forschung 7\" auf Normal, ohne Verluste."
"RD_CAMPAIGN_NO_DEATHS_AREA9800_DESC"	"Beende den Feldzug \"Bereich 9800\" auf Normal, ohne Verluste."
"RD_CAMPAIGN_NO_DEATHS_TFT_DESC"	"Beende den Feldzug \"Tränen für Tanor\" auf Normal, ohne Verluste."
"RD_CAMPAIGN_NO_DEATHS_DC_DESC"	"Beende den Feldzug \"Tote Stadt\" auf Normal, ohne Verluste."
"RD_CAMPAIGN_NO_DEATHS_TIL_DESC"	"Beende den Feldzug \"Tilarus-5\" auf Normal, ohne Verluste."
"RD_CAMPAIGN_NO_DEATHS_LAN_DESC"	"Beende den Feldzug \"Lanas Flucht\" auf Normal, ohne Verluste."
"RD_CAMPAIGN_NO_DEATHS_REDUCTION_DESC"	"Beende den Feldzug \"Reduktion\" auf Normal, ohne Verluste."
"RD_CAMPAIGN_NO_DEATHS_PAR_DESC"	"Beende den Feldzug \"Paranoia\" auf Normal, ohne Verluste."
"RD_CAMPAIGN_NO_DEATHS_ORI_DESC"	"Beende den Feldzug \"Orions Bedrohung\" auf Normal, ohne Verluste."
"RD_CAMPAIGN_NO_DEATHS_NH_DESC"	"Beende den Feldzug \"Nam Humanum\" auf Normal, ohne Verluste."
"RD_CAMPAIGN_NO_DEATHS_BIO_DESC"	"Beende den Feldzug \"BioGen Gesellschaft\" auf Normal, ohne Verluste."
"ASW_MISSION_NO_DEATHS_DESC"	"Schließe einen Einsatz auf Normal ab, ohne Verluste."
"RD_GAS_GRENADE_KILLS_DESC"	"Töte 500 Aliens mit Gasgranaten."
"RD_HEAVY_RIFLE_KILLS_DESC"	"Töte 500 Aliens mit dem schweren Gewehr."
"RD_MEDICAL_SMG_KILLS_DESC"	"Töte 500 Aliens mit der Sanitäter SMG."
"RD_NH_BONUS_OBJECTIVE_DESC"	"Lade in den Grundstein Laboratorien verbotene Daten auf das Schiff."
"ASW_Custom_Music_Col_Genre"	"Genre"
"ASW_Custom_Music_Col_Artist"	"Interpret"
"ASW_Custom_Music_Col_Album"	"Album"
"nb_Ansturm_title"	"Ansturm"
"nb_friendly_fire_title"	"Freundbeschuss"
"asw_difficulty_imba"	"Brutal"
"asw_hardcore_ff"	"Hardcore-Freundbeschuss"
"asw_enabled_Ansturm"	"%s1 hat den Ansturmsmodus aktiviert."
"asw_disabled_Ansturm"	"%s1 hat den Ansturmsmodus deaktiviert."
"asw_enabled_hardcoreff"	"%s1 hat Hardcore-Freundbeschuss aktiviert."
"asw_disabled_hardcoreff"	"%s1 hat Hardcore-Freundbeschuss deaktiviert."
"asw_set_difficulty_easy"	"%s1 hat den Schwierigkeitsgrad auf Leicht umgestellt."
"asw_set_difficulty_normal"	"%s1 hat den Schwierigkeitsgrad auf Normal umgestellt."
"asw_set_difficulty_hard"	"%s1 hat den Schwierigkeitsgrad auf Schwer umgestellt."
"asw_set_difficulty_insane"	"%s1 hat den Schwierigkeitsgrad auf Wahnsinnig umgestellt."
"asw_set_difficulty_imba"	"%s1 hat den Schwierigkeitsgrad auf Brutal umgestellt."
"rd_round_ends_in"	"Runde endet in %s1..."
"rd_instagib_activated"	"InstaGib Spielmodus ist aktiviert"
"rd_instagib_deactivated"	"InstaGib Spielmodus ist deaktiviert"
"rd_gungame_activated"	"Gun Game Spielmodus ist aktiviert"
"rd_gungame_deactivated"	"Gun Game Spielmodus ist deaktiviert"
"rd_schedule_event"	"Plane Event"
"rd_leave_feedback"	"Feedback"
"rd_str_schedule_event"	"Plane ein Spiel-Event"
"rd_schedule_event_information"	"Trete der Steam Gruppe bei und plane ein Spiel-Event \n"
"rd_str_change_team"	"WECHSLE TEAM"
"rd_str_team"	"Team:  %s1"
"rd_str_press_jump_to_respawn"	"- DRÜCKE 'SPRINGEN' UM WIEDER EINZUSTEIGEN -"
"rd_str_press_m_select_marine"	"Drücke 'm' um einen Soldaten auszuwählen"
"rd_str_respawning_in"	"Wiedereinstieg in %s1..."
"rd_str_rotatecameraleft"	"Kamerarotation gegen den Uhrzeigersinn"
"rd_str_rotatecameraright"	"Kamerarotation mit dem Uhrzeigersinn"
"rd_str_selectloadout"	"Wähle Soldaten\Ausrüstung(for PvP game modes)"
"rd_str_drop_extra"	"Zusatzausrüstung abwerfen"
"rd_weapon_deagle"	"Desert Eagle"
"rd_weaponl_deagle"	"Desert Eagle"
"rd_wdesc_deagle"	"Die Desert Eagle Pistole feuert 12.7×33mm Patronen und kann eine Drohne mit einem einzigen Schuss töten. Hocken erhöht die Zielgenauigkeit."
"rd_weapon_deagle_attributes"	"Hoher Schaden"
"rd_ui_select_challenge"	"Herausforderung"
"rd_challenge_name_0"	"Deaktiviert"
"rd_challenge_desc_0"	"Keine spezielle Herausforderung"
"rd_challenge_name_asbi"	"ASBI"
"rd_challenge_desc_asbi"	"Signifikant erhöhter Schwierigkeitsgrad durch mehr Alien-Geschwindikeit und -Anzahls, Anstürme geschehen öfter, erzwungener Hardcore-Freundbeschuss"
"rd_challenge_name_difficulty_tier1"	"Schwierigkeitsstufe 1"
"rd_challenge_name_difficulty_tier2"	"Schwierigkeitsstufe 2"
"rd_challenge_desc_difficulty_tier1"	"Fügt dem Schwierigkeitsgrad Brutal weitere 5 Level hinzu. Leicht bedeutet Brutal + 1, Normal ist Brutal + 2 usw. Alien-Geschwindikeit und -Anzahls werden proportional erhöht."
"rd_challenge_desc_difficulty_tier2"	"Fügt der Schwierigkeitsstufe 1 weitere 5 Lebel hinzu."
"rd_challenge_disabled"	"Herausforderung deaktiviert"
"rd_challenge_enabled"	"Herausforderung enabled: %s1"
"rd_weapon_devastator"	"Devastator"
"rd_weaponl_devastator"	"IAF HAS42 Devastator"
"rd_wdesc_devastator"	"Der IAF HAS42 Devastator ist eine Vollautomatische Nachbereich-Sturmschrotflinte. Die passende IAF Standard Munition ist 12-Gauge Patronen. Waffenspezialisten-Training wird benötigt. Seine verheerende Wirkung macht ihn ideal für große Gruppen an Aliens auf kurze Distanz."
"rd_weapon_devastator_attributes"	"Kurze Distanz. Hoher Schaden"
"rd_weapon_combat_rifle"	"Kampfgewehr"
"rd_weaponl_combat_rifle"	"22A4-2 Kampfgewehr"
"rd_wdesc_combat_rifle"	"Das 22A4-2 Kampfgewehr ist dem 22A3-1 Sturmgewehr sehr ähnlich, statt dem Granatwerfer ist es allerdings mit einer zusätzlichen Schrotflinte für Situationen Nah am Feind ausgestattet. Hoher Schaden und eine weite Streuung erledigen multiple Gegner im Nu."
"rd_weapon_combat_rifle_altfire"	"Schrotmunition"
"rd_weapon_combat_rifle_attributes"	""
"rd_bloom_detail"	"Bloom"
"rd_bloom_detail_tooltip"	"Verändert die Stärke des Bloom Effekts"
"rd_bloom_high"	"Hoch"
"rd_bloom_high_tip"	"Die Stärke des Bloom Effekts den der Level Designer auf dieser Karte vorgesehen hat."
"rd_bloom_medium"	"Mittel"
"rd_bloom_medium_tip"	"50% der vorgesehenen Bloom-Stärke"
"rd_bloom_low"	"Low"
"rd_bloom_low_tip"	"25% der vorgesehenen Bloom-Stärke"
"rd_bloom_none"	"Kein Effekt"
"rd_bloom_none_tip"	"Deaktiviert den Effekt vollständig."
"GameUI_DepthBlur"	"Tiefenunschärfe"
"rdui_game_mode_title"	"Spielmodus"
"rdui_deathmatch_title"	"Deathmatch"
"rdui_deathmatch_tooltip"	"Wiedereinstieg, Waffe finden, alles töten das sich bewegt. Merke! Sarge is OP"
"rdui_gungame_title"	"Gun Game"
"rdui_gungame_tooltip"	"Wiedereinstieg, töten, eine neue Waffe pro Kill"
"rdui_instagib_title"	"InstaGib"
"rdui_instagib_tooltip"	"Ein Treffer = Ein Kill, easy. Denk daran das Crash mit der Schienenwaffe OP ist"
"rdui_tdm_title"	"Team Deathmatch"
"rdui_tdm_tooltip"	"Deine Teamkameraden haben Namen und einen Lebensbalken, schieß nicht auf sie!"
"rd_mainmenu_workshop"	"WORKSHOP"
"rd_mainmenu_workshop_tip"	"Finde neue Feldzüge und Herausforderungen und Modifikationen im Steam Workshop"
"rd_mainmenu_workshop_browse"	"Durchstöbern"
"rd_mainmenu_workshop_manage"	"Verwalten"
"workshop_restart_for_update"	"Reactive Drop neustarten um zu aktualisieren"
"workshop_stat_tags"	"Tags: %s1"
"workshop_stat_author"	"By %s1"
"workshop_stat_play_sessions"	"Weltweit %s1 mal gespielt"
"workshop_stat_play_sessions_1"	"Weltweit %s1 mal gespielt"
"workshop_stat_play_time_hours"	"Weltweit für %s1 Stunden gespielt"
"workshop_stat_play_time_hours_1"	"Weltweit für %s1 Stunde gespielt"
"workshop_stat_play_time_minutes"	"Weltweit für %s1 Minuten gespielt"
"workshop_stat_play_time_minutes_1"	"Weltweit für %s1 Minute gespielt"
"workshop_stat_play_time_seconds"	"Weltweit für %s1 Sekunden gespielt"
"workshop_stat_play_time_seconds_1"	"Weltweit für %s1 Sekunde gespielt"
"workshop_stat_current_subscribers"	"%s1 aktuelle Abonnenten"
"workshop_stat_current_subscribers_1"	"%s1 aktueller Abonnent"
"workshop_stat_unique_viewers"	"%s1 eindeutige Betrachtungen"
"workshop_stat_unique_viewers_1"	"%s1 eindeutige Betrachtung"
"workshop_stat_updated_date"	"Zuletzt aktualisiert am %s1"
"workshop_stat_updated_time"	"Zuletzt aktualisiert heute um %s1"
"workshop_download_from_workshop"	"Verfügbar im Steam Workshop"
"workshop_number_in_queue"	"In der Warteschlange: %s1"
"rd_workshop_dummy_item"	"Neue Workshop Erweiterung"
"rd_workshop_published_addons"	"Veröffentlichte Workshop Erweiterungen"
"rd_workshop_waiting_for_addon_list"	"Warte auf Liste der Erweiterungen..."
"rd_workshop_create_addon"	"NEUE ERWEITERUNG ERSTELLEN"
"rd_workshop_choose_vpk"	"VPK auswählen"
"rd_workshop_choose_vpk_size"	"VPK auswählen (%s1 MB)"
"rd_workshop_editing_preview"	"Vorschaubild: (16:9 aspect ratio, max 1 MB)"
"rd_workshop_choose_jpeg"	"JPEG auswählen"
"rd_workshop_editing_title"	"Titel:"
"rd_workshop_editing_description"	"Beschreibung:"
"rd_workshop_editing_tags"	"Tags: (separiert durch Kommas)"
"rd_workshop_editing_change_description"	"Änderungsliste:"
"rd_workshop_edit_addon"	"EDITIEREN"
"rd_workshop_cancel_edit"	"ABBRECHEN"
"rd_workshop_submit_edit"	"EINREICHEN"
"rd_workshop_open"	"ÖFFNEN"
"rd_workshop_creating_item"	"Objekt wird erstellt..."
"rd_workshop_update_status_invalid"	"Aktualisierung wird verarbeitet..."
"rd_workshop_update_status_preparing_config"	"Konfiguration vorbereiten..."
"rd_workshop_update_status_preparing_content"	"Inhalt vorbereiten..."
"rd_workshop_update_status_uploading_content"	"Inhalt hochladen..."
"rd_workshop_update_status_uploading_preview_file"	"Vorschaubild hochladen..."
"rd_workshop_update_status_committing_changes"	"Änderungen übergeben..."
"rd_workshop_retrieving_item_details"	"Empfange Objekt Details..."
"rd_workshop_downloading"	"Herunterladen... (%s1%)"
"rd_workshop_error_title"	"Workshop Fehler"
"rd_workshop_error_update_preview"	"Fehler beim Aktualisieren des Vorschaubildes."
"rd_workshop_error_update_content"	"Fehler beim Aktualisieren des VPKs."
"rd_workshop_error_update_tags"	"Fehler beim Aktualisieren der Tags."
"rd_workshop_error_update_title"	"Fehler beim Aktualisieren des Titels."
"rd_workshop_error_update_description"	"Fehler beim Aktualisieren der Beschreibung."
"rd_workshop_error_unknown"	"Unbekannter Fehler."
"rd_workshop_error_disallowed_filenames"	"VPK enthält nicht erlaubte Dateinamen."
"rd_workshop_error_io_failure"	"Verbindung verloren."
"rd_workshop_error_insufficient_privilege"	"Es ist dir nicht erlaubt Workshop Erweiterungen hochzuladen."
"rd_workshop_error_timeout"	"Workshop Operation benötigt länger als erwartet."
"rd_workshop_error_not_logged_on"	"Steam Login Verbindungsabbruch."
"rd_workshop_error_jpeg_size_limit"	"Vorschaubilder müssen kleiner als 1 MB sein."
"asw_weapon_healampgun"	"Mobile Amp-Heileinheit"
"asw_weaponl_healampgun"	"IAF Mobile Amp-Heileinheit"
"asw_weapon_healampgun_altfire"	"Verstärkt den Schaden des einzeln beschossenen Teamkollegen."
"asw_weapon_healampgun_attributes"	"Mobile Heilung and Schadensverstärkung"
"asw_wdesc_healampgun"	"Diese experimentelle Version der IAF Mobile Heileinheit kann ihre Heilenergie auch in ein Schadensverstärkendes elektromagnetischen Feld umwandeln das Waffe des anvisierten Soldaten optimiert um dessen Kugeln mit erhöhter Einschlagskraft abzufeuern. Das primäre Feuer heil, das sekondäre verstärkt."
"rd_weapon_50calmg"	"50CMG4-1"
"rd_weaponl_50calmg"	""
"rd_wdesc_50calmg"	"Die 50cal is stark genug um einen Schildkäfer per Frontalangriff in wenigen Sekunden zu töten."
"rd_weapon_50calmg_attributes"	""
//
// Lanas Flucht objectives
//
// as_sci1_bridge OBJECTIVES
//
"asw_ob_lanasbridge_1t"	"Zugang zur Brücke erhalten"
"asw_ob_lanasbridge_1"	"Kader, wir erhalten automatische Meldungen, dass eine IAF-Waffenanlage auf Planet 137 ihr Sicherheitssystem aktiviert hat. Da wir keine Antwort vom örtlichen Hauptverwalter erhalten haben, schickt uns die IAF, um das zu untersuchen."
"asw_ob_lanasbridge_1b"	"Äußerste Vorsicht ist geboten, um ein Feld von bewegungserkennenden Minen jenseits des Landeplatzes zu durchqueren."
"asw_ob_lanasbridge_1c"	"Danach müsst ihr einen Weg finden, um auf die Brücke zu gelangen."
"asw_ob_lanasbridge_2t"	"Über die Brücke"
"asw_ob_lanasbridge_2"	"Überquere die Brücke und finde einen Weg in die Festung."
"asw_ob_lanasbridge_3t"	"Infiltriert die Einrichtung"
"asw_ob_lanasbridge_3"	"Ihr müsst einen Weg finden, die Anlage durch das Abfallbehandlungssystem zu infiltrieren."
"asw_ob_lanasbridge_3b"	"Eine schwere Tür versperrt den Weg, aber mit etwas Glück lässt sie sich öffnen."
//
// as_sci1_bridge HINTS
//
"asw_hint_lanasbridge_1"	"Findet einen Weg, um Zugang zur Brücke zu bekommen"
"asw_hint_lanasbridge_2"	"Brücke autorisiert"
"asw_hint_lanasbridge_3"	"Über die Brücke"
"asw_hint_lanasbridge_4"	"Minen entdeckt"
//
// as_sci2_sewer OBJECTIVES
//
"asw_ob_lanassewer_1t"	"Untersuchet die abnormen Signaturen"
"asw_ob_lanassewer_1"	"Abnormale kinetische Signaturen kommen aus dem Hauptbereich darunter."
"asw_ob_lanassewer_1b"	"Eines ist sicher: Das kann nicht freundlich sein."
"asw_ob_lanassewer_2t"	"Begebet euch zur Wartungseinrichtung"
"asw_ob_lanassewer_2"	"Truppe, dieser Ort ist gefährlich. Schwere Maschinen, Pumpensysteme, und das Schlimmste: riesige kinetische Signaturen auf meinen Bildschirmen."
"asw_ob_lanassewer_2b"	"Eure Aufgabe ist einfach: Mach dich auf den Weg an die Oberfläche."
//
// as_sci2_sewer HINTS
//
"asw_hint_lanassewer_1"	"Tunnel versiegelt"
"asw_hint_lanassewer_2"	"Eröffnung..."
//
// as_sci3_maintenance OBJECTIVES
//
"asw_ob_lanasmaintenance_1t"	"Repariert alle beschädigten elektrischen Geräte"
"asw_ob_lanasmaintenance_1"	"Laut dem System der Anlage findet ihr drei beschädigte elektrische Geräte. Repariert sie alle drei, um den Generator wieder in Betrieb zu nehmen."
"asw_ob_lanasmaintenance_2t"	"Bringt den Generator wieder zum Laufen"
"asw_ob_lanasmaintenance_2"	"Versorgt den Generator mit Strom, um die Tür zu aktivieren, die zu den Lüftungsöffnungen führt."
"asw_ob_lanasmaintenance_3t"	"Geht zu den Lüftungsschächten"
"asw_ob_lanasmaintenance_3"	"Der Hauptzugang zum Lüftungsschacht sollte sich öffnen, sobald der Strom eingeschaltet wird. Möglicherweise müsst ihr während des Vorgangs diese Position halten."
//
// as_sci3_maintenance HINTS
//
"asw_hint_lanasmaintenance_1"	"Kein Strom. Schaltet den Generator wieder ein."
"asw_hint_lanasmaintenance_2"	"Ausfall des Generators"
"asw_hint_lanasmaintenance_3"	"Reaktiviert den Generator"
//
// as_sci4_vent OBJECTIVES
//
"asw_ob_lanasvent_1t"	"Findet den Weg aus den Schächten"
"asw_ob_lanasvent_1"	"Sucht eine Ausgangstür, die nach draußen führt."
"asw_ob_lanasvent_2t"	"Eingabe der korrekten Detonationsfolge"
"asw_ob_lanasvent_2"	"Um den Sprengstoff zu zünden, müsst ihr die richtige Zündfolge eingeben."
"asw_ob_lanasvent_3t"	"T75 aktivieren"
"asw_ob_lanasvent_3"	"Die Kolonisten werden Sprengladungen an den Plattformen angebracht haben. Wir haben keine Informationen über den genauen Standort dieser Sprengladungen. Bleibt auf der Hut, Marines!"
"asw_ob_lanasvent_4t"	"Flieht!"
"asw_ob_lanasvent_4"	"Die Plattformen werden nach der Detonation schnell zerstört werden, also beeilt euch um zum Hauptkomplex der Anlage zu gelangen."
//
// as_sci4_vent HINTS
//
"asw_hint_lanasvent_1"	"Findet den Weg aus den Schächten"
"asw_hint_lanasvent_2"	"Gebt die Detonationsfolge ein!"
"asw_hint_lanasvent_3"	"Lauft zum Komplex!"
//
// as_sci5_complex OBJECTIVES
//
"asw_ob_lanascomplex_1t"	"Sicherheitscodes einholen"
"asw_ob_lanascomplex_1"	"Lade die Sicherheitscodes für die Landung herunter, damit der Bloodhound die automatische Luftabwehr überwinden und zur Extraktion kommen kann."
"asw_ob_lanascomplex_2t"	"Nuklearer Sprengkopf"
"asw_ob_lanascomplex_2"	"Bringt den Sprengkopf in das Hauptsilo."
"asw_ob_lanascomplex_2b"	"Ihr müsst die Atombombe manuell durch das Bahnsystem führen und sie zum Lagersilo ihrer Schwester bringen, wo sich der Schwarm eingenistet hat."
"asw_ob_lanascomplex_2c"	"Nach unseren Informationen dürfte der Zünder bereits eingestellt und verriegelt sein. Wer auch immer dafür verantwortlich war, konnte die Arbeit offenbar nicht beenden. Ihr wisst, was zu tun ist, Marines!"
"asw_ob_lanascomplex_3t"	"Fliehen!"
"asw_ob_lanascomplex_3"	"Steig in den Bloodhound für die Extraktion."
"asw_ob_lanascomplex_4t"	"Countdown"
"asw_ob_lanascomplex_4"	"Marines, die Zeit ist bei diesem Einsatz nicht unser Verbündeter."
"asw_no_power_waiting"	"Ich warte..."
//
// as_sci5_complex HINTS
//
"asw_hint_lanascomplex_1"	"Nuklearer Sprengkopf gestoppt!"
"asw_hint_lanascomplex_2"	"Wächter aktiviert"
//
// End of Lanas Flucht text
"rd_ui_4_slots"	"4 Plätze"
"rd_ui_4_slots_tt"	"4 Spieler können auf diesem Server spielen"
"rd_ui_8_slots"	"8 Slots"
"rd_ui_8_slots_tt"	"8 Spieler können auf diesem Server spielen"
"rd_ui_max_players"	"MAXIMALE SPIELER"
"asw_chat_died"	"%s1 wurde getötet!"
// Area9800 strings
"rd_area9800LZ_ob_destroy"	"Sichert den Hangar"
"rd_area9800LZ_ob_destroy_d"	"Wir haben den Kontakt zu Area9800 verloren. Sichert den Hangar und untersucht ihn auf mögliche Anomalien."
"rd_area9800LZ_ob_bridge"	"Aktiviere die Brücke"
"rd_area9800LZ_ob_bridge_d"	"Die Standard-Isolationsprozedur sollte die Brücke heruntergelassen haben. Hack das Zugangspaneel, um durchzukommen *Standard Root-Zugang AuthCode : z884gdi24sd7fsp*"
"rd_area9800LZ_ob_download"	"Informationen vom Computer abrufen"
"rd_area9800LZ_ob_download_d"	"Verwende den optischen Standardspeicher, den du bei der Einsatzbesprechung erhalten hast, um alle Informationen vom Computer herunterzuladen."
"rd_area9800LZ_ob_exit"	"Zugang zum Kraftwerk"
"rd_area9800LZ_ob_exit_d"	"Hier ist eine weitere Sicherheitstür, bevor du das Kraftwerk betreten kannst, um weiterzumachen"
"rd_area9800LZ_debrief"	"Es hat sich herausgestellt, dass es sich um eine weitere Alien-Invasion handelt. Team Bravo wird den Ort sichern, während dein Team weiter vorrücken wird. Haltet Ausschau nach möglichen Überlebenden."
"rd_area9800PP1_ob_generator"	"Backup-Generator in Betrieb nehmen"
"rd_area9800PP1_ob_generator_d"	"Es scheint, als wäre der Strom ausgefallen, das gehört nicht zum Standard-Isolationsverfahren. Was auch immer die Ursache war, du musst den Notstromgenerator einschalten, der die Türen mit Strom versorgt."
"rd_area9800PP1_ob_inner_facility"	"Zugang zur inneren Anlage"
"rd_area9800PP1_ob_inner_facility_d"	"Eine Reihe von Sicherheitstüren trennt dein Team von der inneren Anlage, in der sich der Rest deiner Missionsziele befindet. Kümmere dich um sie."
"rd_area9800PP1_ob_cooling_pump"	"Start up Kühlpumpe"
"rd_area9800PP1_ob_cooling_pump_d"	"Ihr müsst jetzt die Hauptgeneratoren neu starten. Die brauchen Wasserkühlung."
"rd_area9800PP1_ob_exit"	"Geh zur Benzinpumpe"
"rd_area9800PP1_ob_exit_d"	"Als Nächstes kommt die Kraftstoffpumpe für den Generator."
"rd_area9800PP1_debrief"	"Da draußen ist eine höllische Verseuchung, dein Befehl lautet, mit den restlichen Missionen fortzufahren."
"rd_area9800PP2_ob_fuel_pump"	"Kraftstoffpumpe in Betrieb nehmen"
"rd_area9800PP2_ob_fuel_pump_d"	"Das ist die Benzinpumpe, von der wir sprachen, wirf sie an!"
"rd_area9800PP2_ob_generators"	"Start up Generators"
"rd_area9800PP2_ob_generators_d"	"Gekühlt und betankt, Zeit, die Hauptgeneratoren zu starten."
"rd_area9800PP2_ob_maincomp"	"Hauptcomputer hacken"
"rd_area9800PP2_ob_maincomp_d"	"Wenn der Strom endlich wieder da ist, gehst du rüber und hackst den Hauptrechner. Holt euch alles, was ihr findet. Ich hoffe, der optische Speicher hat bis jetzt überlebt."
"rd_area9800PP2_ob_exit"	"Begeben Sie sich zum Ausgang des Kraftwerks"
"rd_area9800PP2_ob_exit_d"	"Zeit zu verschwinden. Geh zur Tür an der Oberfläche"
"rd_area9800PP2_debrief"	"Wir haben alle Informationen, die unsere Wissenschaftsteams haben wollten, und jetzt ist es Zeit, zu verschwinden. Leider konnte Team Bravo den Eingang nicht mehr sichern, also müsst ihr durch das Ödland gehen."
"rd_area9800WL_ob_bridge_gate"	"Öffne einen Weg zur Brücke"
"rd_area9800WL_ob_bridge_gate_d"	"Jetzt, wo du die stark verseuchte Einrichtung hinter dir gelassen hast, sollte es einfacher werden."
"rd_area9800WL_ob_fake_bridge"	"Überquere die Brücke im Osten"
"rd_area9800WL_ob_fake_bridge_d"	"Überquere die Brücke und triff dich mit Team Bravo bei den Koordinaten : 11SPB 05458 21604"
"rd_area9800WL_ob_bridge_failed"	"(FAILED) Die Brücke ist explodiert. Es sollte einen alternativen Weg geben"
"rd_area9800WL_ob_small_bridge"	"Den Gehweg absenken"
"rd_area9800WL_ob_muck_gate"	"Öffne die Schleuse"
"rd_area9800WL_ob_exit"	"Lass das Ödland"
"rd_area9800WL_debrief"	"Mission beendet, ab ins Hauptquartier zur Nachbesprechung und zum Ausruhen, vergiss nicht, den optischen Speicher an unsere Wissenschaftsteams zu übergeben. Trotz dieses Erfolges haben wir den Kontakt zu Team Bravo verloren."
// Forschung 7 strings
"rd_res1_ob_poweron1"	"Die Macht wiederherstellen"
"rd_res1_ob_poweron1_d"	"Schalte den Notstromgenerator ein, um die Stromversorgung der Luftschleuse wiederherzustellen."
"rd_res1_ob_airlock1"	"Öffne die Luftschleuse"
"rd_res1_ob_airlock1_d"	"Die Luftschleuse ist wieder in Betrieb, benutze das Panel, um sie zu öffnen."
"rd_res1_ob_escape2"	"Zugriff auf die Einrichtung"
"rd_res1_ob_escape2_d"	"Öffne die Luftschleuse, um durch die Anlage zu gehen."
"rd_res1_ob_escape"	"Gehen Sie in die Einrichtung"
"rd_res1_ob_escape_d"	"Geh in die Einrichtung der Forschung 7."
"nb_commander_connecting"	"Verbinden..."
"rd_out_of_meds"	"%s1 hat keine Medikamente mehr."
"nb_leaderboard"	"LEADERBOARD"
"nb_leaderboard_error"	"Beim Herunterladen der Rangliste ist ein Fehler aufgetreten."
"nb_leaderboard_not_found"	"Keiner deiner Freunde ist auf dieser Rangliste!"
"rd_order_marine_hold"	"Marinestützpunkt bestellen"
"rd_challenge_selection_title"	"CHALLENGE"
"rd_challenge_selection_error"	"Fehler beim Laden von Challenge-Daten."
"rd_challenge_selection_no_description"	"Keine Beschreibung angegeben."
"rd_challenge_selection_source_official"	"Offizielle Herausforderung"
"rd_challenge_selection_source_manually_installed"	"Manuell installiert"
"rd_challenge_selection_source_workshop"	"Workshop: %s1"
"rd_challenge_selection_author"	"Von: %s1"
"rd_challenge_selection_author_official"	"Vom Reactive Drop Team"
"rd_ada2_ob_eggs1"	"Räumt das Gebiet"
"rd_ada2_ob_dead_end1a"	"Der Scanner zeigt, dass der Weg vor uns höchstwahrscheinlich blockiert ist"
"rd_ada2_ob_dead_end1b"	"Untersuche die Blockade und setze die Route durch den Industriekomplex fort"
"rd_ada2_ob_dead_end1_t"	"Zugang zum industriellen Komplex"
"rd_ada2_ob_eggs2"	"Mit noch mehr Schwarm-Eiern auf dem Weg umgehen"
"rd_ada2_ob_eggs2_t"	"Mehr Eier zum Zerstören"
"rd_ada2_ob_airlockcodeA"	"Daten herunterladen, um auf Airloscks zuzugreifen."
"rd_ada2_ob_airlockcodeB"	"Dann geh tiefer hinein."
"rd_ada2_ob_airlockcode_t"	"Daten herunterladen und Luftschleusen passieren"
"rd_ada2_ob_dead_end2A"	"Scanner zeigt seltsame Anomalie auf dem Weg"
"rd_ada2_ob_dead_end2B"	"Untersuche es."
"rd_ada2_ob_dead_end2_t"	"Anomalie"
"rd_ada2_ob_escapeA"	"Warte, bis der Lift frei ist"
"rd_ada2_ob_escapeB"	"und evakuieren!"
"rd_ada2_ob_escape_t"	"Unvermeidliche Evakuierung"
"rd_ada2_debrief"	"Gut gemacht, Team!"
"rd_ada3_ob_antenn1"	"Versuche, ein Signal zur Evakuierung zu senden"
"rd_ada3_ob_antenn1_t"	"Untersuche den nächsten Satelliten"
"rd_ada3_ob_ships1"	"Suche nach den Schiffen, die dir helfen können"
"rd_ada3_ob_ships1_t"	"Unterstützende Schiffe"
"rd_ada3_ob_ships2"	"Schiff kontrollieren, um den Weg frei zu machen"
"rd_ada3_ob_ships2_t"	"Kisten rausholen"
"rd_ada3_ob_spaceport"	"Erreiche das Gebiet der Raumhafensatelliten"
"rd_ada3_ob_spaceport_t"	"Letzte Hoffnung"
"rd_ada3_ob_last_antenn"	"Versuch, den Satelliten zu reaktivieren"
"rd_ada3_ob_last_antenn_t"	"Die Hoffnung stirbt nie"
"rd_ada3_ob_escape"	"Warte, bis die Hilfsschiffe kommen"
"rd_ada3_ob_escape2"	"und Flucht zum Verbotenen Außenposten"
"rd_ada3_ob_escape_t"	"Flucht"
"rd_ada3_debrief"	"Gut gemacht, Team!"
"rd_ada4_ob_eggs"	"Mutagene Schwarm-Eier zerstören"
"rd_ada3_ob_lost_marineA"	"Finde den verlorenen Marine mit einem speziellen Elektrogerät"
"rd_ada3_ob_lost_marineB"	"Hüte dich vor tiefem und radioaktivem Wasser"
"rd_ada3_ob_lost_marine_t"	"Versuch, den Satelliten zu reaktivieren"
"rd_ada4_ob_escapeA"	"Erreiche den Außenposten"
"rd_ada4_ob_escapeB"	"Wir brauchen Munition und so"
"rd_ada4_ob_escape_t"	"Erreiche den Außenposten"
"rd_ada4_debrief"	"Gut gemacht, Team!"
"RD_MainMenu_Training"	"AUSBILDUNG"
"RD_MainMenu_Training_Tip"	"Lerne, wie man das Spiel spielt, indem du diese Trainingskarte abschließt"
"rdui_gamesettings_network_bandwidth"	"Maximal akzeptable Bandbreite für Spielverkehr"
"rdui_bandwidth_extremely_restricted"	"Extrem restriktiv"
"rdui_bandwidth_384kbps"	"384 kbps"
"rdui_bandwidth_512kbps"	"512 kbps"
"rdui_bandwidth_768kbps"	"768 kbps"
"rdui_bandwidth_1mbps"	"1 Mbit/s"
"rdui_bandwidth_1_5mbps"	"1,5 Mbit/s"
"rdui_bandwidth_2mbps"	"2 Mbps"
"rdui_bandwidth_2_5mbps"	"2,5 Mbit/s"
"rdui_bandwidth_3mbps"	"3 Mbit/s"
"rdui_bandwidth_4mbps"	"4 Mbit/s"
"rdui_bandwidth_unrestricted"	"Uneingeschränkt"
"rdui_mainmenu_options_gamesettings"	"Spieleinstellungen"
"rdui_gamesettings_deathcam"	"Todeskamera"
"rdui_deathcam_disabled"	"Deaktiviert"
"rdui_deathcam_0"	"Nur Verlangsamung"
"rdui_deathcam_1"	"Cinematic Death Camera"
"rd_chat_marine_reserved"	"Dieser Soldat ist für %s1 Sekunden reserviert"
"GameUI_Language_Czech"	"Tschechisch"
"GameUI_Language_Hungarian"	"Ungarisch"
"GameUI_Language_Romanian"	"Rumänisch"
"GameUI_Language_Turkish"	"Türkisch"
"GameUI_Language_Ukrainian"	"Ukrainisch"
"rd_so_appears_title"	"Erscheint in"
"rd_so_appears_no_challenge"	"Keine Herausforderung"
"rd_so_appears_campaign_map"	"%s1: %s2"
"rd_so_appears_mission_challenge"	"%s1 (%s2)"
"rd_so_appears_everywhere"	"Nahezu jede Mission"
"rd_so_appears_difficulty_single"	"%s1 (nur %s2)"
"rd_so_appears_difficulty_min"	"%s1 (%s2 oder härter)"
"rd_so_appears_difficulty_max"	"%s1 (%s2 oder einfacher)"
"rd_so_appears_difficulty_range"	"%s1 (%s2 bis %s3)"
"rd_so_appears_Ansturm_only"	"%s1 (nur Ansturm)"
"rd_so_alien_drone"	"Drohne"
"rd_so_alien_ranger"	"Ranger"
"rd_so_alien_shieldbug"	"Schildkäfer"
"rd_so_alien_boomer"	"Boomer"
"rd_so_alien_buzzer"	"Schnarre"
"rd_so_alien_parasite"	"Parasit"
"rd_so_alien_mortarbug"	"Mortarbug"
"rd_so_alien_harvester"	"Raffer"
"rd_so_alien_parasite_defanged"	"Xenomite"
"rd_so_alien_shaman"	"Schamane"
"rd_so_alien_biomass"	"Biomasse"
"rd_so_alien_grub"	"Grub"
"rd_so_alien_antlionguard"	"Antlion-Wächter"
"rd_so_alien_carrier_drone"	"Träger-Drone"
"rd_so_alien_summoner_drone"	"Beschwörer-Drone"
"rd_so_display_caption_specimen_a"	"Exemplar A"
"rd_so_display_caption_specimen_b"	"Exemplar B"
"rd_so_display_caption_specimen_c"	"Exemplar C"
"rd_so_display_caption_specimen_d"	"Exemplar D"
"rd_so_ability_alerts_swarm"	"Schwarm der Alarme"
"rd_so_ability_attacks_doors"	"Angriffe auf Türen"
"rd_so_ability_charging_attack"	"Auflade-Attacke"
"rd_so_ability_corrosive_skin"	"Ätzende Haut"
"rd_so_ability_corrosive_spit"	"Ätzende Spucke"
"rd_so_ability_explosive_projectiles"	"Explosive Geschosse"
"rd_so_ability_explosive_spawn"	"Explosiver Laich"
"rd_so_ability_flight"	"Flucht"
"rd_so_ability_harmless"	"Harmlos"
"rd_so_ability_hatches_from_eggs"	"Schlüpft aus Eiern"
"rd_so_ability_hatches_from_sacs"	"Schlüpfen aus Säcken"
"rd_so_ability_heals_other_aliens"	"Heilt andere Aliens"
"rd_so_ability_immune_to_frontal_attacks"	"Unempfindlich gegen Frontalangriffe"
"rd_so_ability_infested_by_parasite"	"Vom Parasiten befallen"
"rd_so_ability_infests_marines"	"Befallen Marines"
"rd_so_ability_inflates"	"Aufgeblasen"
"rd_so_ability_jumping_attack"	"Springende Attacke"
"rd_so_ability_knocks_down_marines"	"Knocks Down Marines"
"rd_so_ability_long_range"	"Long Range"
"rd_so_ability_only_vulnerable_to_fire"	"Nur durch Feuer verwundbar"
"rd_so_ability_overwhelming_numbers"	"Überwältigende Zahlen"
"rd_so_ability_poison_blurs_vision"	"Poison Blurs Vision"
"rd_so_ability_razor_sharp_claws"	"Rasiermesserscharfe Krallen"
"rd_so_ability_resistant_to_damage"	"Widerstandsfähig gegen Beschädigungen"
"rd_so_ability_suicide_bomber"	"Selbstmordbomber"
"rd_so_paragraph_drone_0"	"Drohnen machen den Großteil der Anzahl und der \"Manpower\" des Schwarms aus. Marines müssen damit rechnen, dass sie auf mehrere Dutzend von ihnen pro Mission treffen und im Laufe einer Kampagne möglicherweise mehrere Hundert von ihnen töten."
"rd_so_paragraph_drone_1"	"Drohnen sind schwach in Bezug auf ihre Haltbarkeit, aber schnell, stark und zahlreich. Ihre vier massiven Klauen können Marinesoldaten, die das Pech haben, getroffen zu werden, schreckliche Verletzungen zufügen. Von Drohnen umschwärmt zu werden (vor allem, wenn du ein leeres Gewehr und keine Ersatzwaffe hast), ist ein todsicherer Weg, um zu sterben, egal auf welchem Schwierigkeitsgrad. Eine einzelne Drohne ist nur eine geringe Bedrohung für einen Marinesoldaten und kann leicht mit einer Waffe oder einem Nahkampfangriff ausgeschaltet werden."
"rd_so_paragraph_drone_2"	"Drohnen zu bekämpfen ist einfach: Lass deine Schüsse zählen, bleib zusammen und gib deinen Teamkameraden Deckung, während sie nachladen oder wenn sie bedrängt werden."
"rd_so_paragraph_drone_3"	"Drohnen bewegen sich langsamer, wenn sie durch das Prototyp-Sturmgewehr oder die Teslakanone unter Strom gesetzt werden - beides verlangsamt oder schädigt Teamkameraden nicht, also nutze dies zu deinem Vorteil. Wenn du eine Gruppe von Drohnen betäubst, die sich auf einen Teamkameraden stürzen, kannst du ihm Zeit verschaffen, sich zurückzuziehen, nachzuladen, Gegenstände zu benutzen und so weiter."
"rd_so_paragraph_drone_4"	"Drohnen, die in Flammen stehen, z.B. von einer M868 Flamer-Einheit, werden verlangsamt und hören oft auf, Marines anzugreifen und stolpern in Flammen herum."
"rd_so_paragraph_drone_5"	"Drohnen sind auf Brutal sehr tödlich, denn ein einziger Treffer ihrer Klauen kann die Gesundheit schwächerer Charaktere (z. B. Sanitäter) um fast die Hälfte reduzieren. Außerdem können sie viel mehr Schaden aushalten, wodurch einfache Waffen gegen sie weniger effektiv sind. Es wird dringend empfohlen, dass mindestens ein Spieler eine Minigun oder Autogun bei sich trägt, um mit Drohnenschwärmen fertig zu werden."
"rd_so_paragraph_ranger_0"	"Als eine der wenigen Schwarm-Lebensformen mit einem Fernkampfangriff feuern Waldläufer eine Salve säurehaltiger Geschosse über mittlere bis große Entfernungen ab und belästigen Trupps aus der Ferne. Einzeln sind sie schwach und ihre Geschosse können von geistesgegenwärtigen Menschen abgewehrt werden, aber in großer Zahl oder mit Unterstützung von Drohnen können sie zu einer Plage werden. Waldläufer sind zäher als Drohnen und können einiges einstecken - auf Wahnsinnig kann ein Waldläufer sogar einen direkten Granattreffer überleben."
"rd_so_paragraph_ranger_1"	"Sobald ein Waldläufer seine Gliedmaßen ausbreitet, kann er sich nicht mehr drehen, bis er in die Richtung geschossen hat, in die er gerade schaut. Nutze diese Gelegenheit, um für einen Nahkampfangriff zu kreisen oder bereite dich darauf vor, seinen Geschossen auszuweichen."
"rd_so_paragraph_shieldbug_0"	"Schildkäfer können im Vergleich zu den meisten Käfern große Mengen an Schaden absorbieren und haben massive, gepanzerte Gliedmaßen, die ihnen ihren Namen geben."
"rd_so_paragraph_shieldbug_1"	"Die beste Art, einen Schildkäfer zu töten, ist, ihn von hinten anzugreifen und auf die gelb-weiße Ansammlung auf der Rückseite seines Körpers zu zielen. Ein Angriff von vorne ist unwirksam, und der Schildkäfer hat einen starken Nahkampfangriff, der einen Marinesoldaten weit wegschleudern kann - sei also vorsichtig."
"rd_so_paragraph_shieldbug_2"	"Schildkäfer suchen sich in der Regel einen einzelnen Marinesoldaten aus (in der Regel den, der ihnen am nächsten ist oder sie angreift) und bewegen sich dann langsam auf sie zu. Die anderen Marinesoldaten haben dann die Möglichkeit (und sollten sie auch nutzen), den Schildkäfer zu flankieren und zu töten, während er abgelenkt ist."
"rd_so_paragraph_shieldbug_3"	"Wenn du allein bist und keine Granaten oder Waffen hast, die dich betäuben können, ist die einzige brauchbare Strategie, die du verfolgen kannst, den Schildkäfer in seinen Verteidigungsmodus zu locken und zu warten, bis er dich angreift. Dadurch wird er kurzzeitig daran gehindert, sich auf dich zu drehen und du kannst seinen Rücken angreifen."
"rd_so_paragraph_shieldbug_4"	"Vermeide es, Schildkäfer in der Nähe einer Brücke oder Klippe anzugreifen. Wenn der Schildkäfer im richtigen Winkel zuschlägt, stößt er dich von der Kante ins Nichts, tötet dich und verhindert, dass andere Marines deine Ausrüstung plündern."
"rd_so_paragraph_boomer_0"	"Boomer sind große, dreifüßige Kreaturen, deren einziger Zweck es zu sein scheint, als gigantischer Selbstmordattentäter zu agieren. Boomer können sich rollen, um sich schnell zu nähern und einem Schiff den Weg zu versperren."
"rd_so_paragraph_boomer_1"	"Wenn ein Boomer getötet wird, bevor er sich aufblähen kann, stellt er kaum eine Bedrohung für ein Team dar, aber wenn er sich aufbläht, werden mehrere \"bombenähnliche\" Geschosse freigesetzt, die nach einigen Sekunden explodieren und den Marines in der Nähe erheblichen Schaden zufügen."
"rd_so_paragraph_buzzer_0"	"Schnarren sind kleine fliegende Insektoide, die sich gerne von oben herabstürzen. Sie sind lästig, aber keine große Bedrohung. Ihre Fähigkeit, Marinesoldaten zu verwirren und abzulenken, die sonst mit anderen Schwarmlebewesen zu tun hätten, macht sie lästig."
"rd_so_paragraph_buzzer_1"	"Sie verursachen relativ wenig Schaden, stellen aber ein kleines Ziel dar, das schwer zu treffen ist, es sei denn, du verwendest eine Waffe mit automatischer Zielhilfe, wie das 22A7-Z Prototype Assault Rifle oder die S23A SynTek Autogun."
"rd_so_paragraph_parasite_0"	"Der Parasit ist eine der gefährlichsten Lebensformen des Schwarms, weil er in einem unbewussten Wirt schnell weitere Parasiten heranreifen lässt. Wenn ein Schiff stirbt, während es befallen ist, werden vier zusätzliche Parasiten aus seinem Körper geschleudert. Die einzige Möglichkeit, den Befall zu beseitigen, besteht darin, den befallenen Marine zu heilen (mit der Medizinischen Kanone oder den Heilungsbaken), bis der gelbe Teil seiner Gesundheitsleiste verschwunden ist, oder eine elektrisch aufgeladene Rüstung zu aktivieren. Persönliche IAF-Heilungssets sind sehr unwirksam bei der Heilung von Befall, aber ein Kit kann dich für ein paar Sekunden länger am Leben halten und den Sanitätern mehr Zeit geben, dich zu heilen."
"rd_so_paragraph_parasite_1"	"Im Gegensatz zu ihrem Lebensraum im Spiel scheint ihr biologischer Lebensraum eine feuchte Umgebung zu benötigen, sei es in der Luft oder auf einer Oberfläche. Dafür spricht auch die Tatsache, dass die Eier, aus denen sie laichen, eine unappetitliche Flüssigkeit enthalten."
"rd_so_paragraph_mortarbug_0"	"Mörtelkäfer sind große Unterstützungseinheiten, die eine Reihe von drei hochexplosiven Geschossen über große Entfernungen spucken, wie eine verbesserte Version des Waldläufers. Diese Geschosse explodieren nicht sofort, sondern bleiben am Boden und an den Wänden haften und explodieren dann nach etwa drei Sekunden, wobei sie allen in der Nähe befindlichen Personen erheblichen Schaden zufügen."
"rd_so_paragraph_mortarbug_1"	"Wenn sie nicht schnell getötet werden, können sie einen Trupp belästigen und verhindern, dass dieser Zugang zu einem Gebiet erhält. Auf kurze Distanz sind sie im Grunde wehrlos, aber wie die Waldläufer liegt ihre Hauptstärke darin, andere Mitglieder des Schwarms zu unterstützen, indem sie ihre Bomben einsetzen, um die Bewegung der Marines einzuschränken oder den Trupp aufzuteilen."
"rd_so_paragraph_harvester_0"	"Der Raffer ist eine große bräunliche Kreatur mit einem leuchtenden knolligen Anhängsel. Er ist eine Unterstützungseinheit, die winzige selbstmörderische Xenomiten hervorbringt, anstatt den Trupp direkt anzugreifen. Der Raffer selbst ist relativ zerbrechlich und leicht zu töten, aber wie der Ranger oder der Mortarbug kann er viel effektiver sein, wenn er andere Schwarmeinheiten unterstützt und Marines belästigt, während Drohnen sie ablenken."
"rd_so_paragraph_harvester_1"	"Raffer sollten schnell ausgeschaltet werden, um den Effekt, den sie auf einen Kampf haben, zu minimieren, ähnlich wie der Mortarbug. Wenn ein Raffer getötet wird, setzt er mehrere Xenomiten frei, die direkt in die Luft fliegen, bevor sie landen und Marines in der Nähe angreifen."
"rd_so_paragraph_harvester_2"	"Wenn du den Raffer tötest, während er brennt oder gefroren ist, werden auch die Xenomiten getötet, die er beim Tod freisetzt."
"rd_so_paragraph_harvester_3"	"Obwohl er nicht direkt angreifen kann, verursacht der physische Kontakt mit dem Raffer Schaden bei Marines. In Verbindung mit ihrer Fähigkeit, alle paar Sekunden Xenomiten zu produzieren, sind Nahkampfangriffe gegen Raffer generell nicht ratsam."
"rd_so_paragraph_harvester_4"	"Wenn er bedroht wird, versucht der Raffer, sich aus dem Kampf zurückzuziehen, produziert aber weiterhin Xenomiten. Es ist ratsam, den Raffer zu verfolgen und zu zerstören, bevor zu viele Xenomiten produziert werden."
"rd_so_paragraph_parasite_defanged_0"	"Der Xenomit ist ein kleiner, rot-weißer Insektoid, der angreift, indem er auf einen Marine springt und explodiert, um sein Ziel mit einer ätzenden Substanz zu bespritzen. Einzeln stellen diese Xenomiten keine große Bedrohung für einen Meeresbewohner dar, aber es ist Vorsicht geboten, denn ihr Angriff kann einen Meeresbewohner zurückwerfen und ihn verwirren."
"rd_so_paragraph_parasite_defanged_1"	"Obwohl er in Größe, Form und Bewegung dem Parasiten ähnelt, kann der Xenomit leicht an seiner rot-weißen Farbe im Gegensatz zur gelben des Parasiten unterschieden werden, und sein Angriff kann nicht mit elektrisch aufgeladener Rüstung negiert werden."
"rd_so_paragraph_biomass_0"	"\"Biomasse\" ist ein Begriff für große, statische Ansammlungen von organischen Materialien, die der Schwarm verwendet, um massive bienenstockähnliche Strukturen aufzubauen. Die Anhäufung von Biomasse ist eines der ersten Anzeichen für die Bildung von Bienenstöcken, deshalb muss sie so schnell wie möglich beseitigt werden."
"rd_so_paragraph_biomass_1"	"Biomasse ist immun gegen Kugeln, Sprengstoff und Nahkampfangriffe; sie kann nur durch Brandwaffen (wie die M868 Flamer-Einheit, die Brandgranate des Vindicators und die Proximity Incendiary Mine) oder den Mining Laser zerstört werden."
"rd_so_paragraph_biomass_2"	"Ein Haufen toter Kolonisten in der Nähe der Biomasse in der Timor-Station deutet darauf hin, dass die Biomasse \"zusammengebaut\" wird, indem jegliches organische Material aufgenommen wird, das erworben werden kann. Das könnte bedeuten, dass sich die Kolonisten sowie ihre Haustiere und Lebensmittel tot oder lebendig in der Biomasse befinden."
"rd_so_paragraph_biomass_3"	"Biomasse selbst ist weitgehend wehrlos und harmlos, auch wenn der Kontakt mit ihr leichten Schaden anrichtet und einen Marine zurückwirft."
"rd_so_paragraph_biomass_4"	"Sobald die Biomasse entzündet ist, stirbt sie schließlich ab. Anhaltende Brandschäden sind nicht notwendig, aber sie beschleunigen den Prozess."
"rd_so_paragraph_grub_0"	"Eine Larve ist vermutlich das Larvenstadium des Schwarms. Sie ist etwa so groß wie der Fuß eines Marines und wird von Marines angezogen, ist aber nicht in der Lage, ihnen zu schaden. Die Larven kommen in Säcken von etwa einem Dutzend vor, die sich bei Feuer oder wenn ein Marine in der Nähe ist, öffnen."
"rd_no_steam_service"	"Spiel kann sich nicht mit dem Steam-Dienst verbinden"
"rd_no_steam_solutions"	"Mögliche Lösungen: Steam oder Computer neu starten, Spiel in Antivirus oder Firewall zulassen, Integrität der Spieldateien überprüfen"
"rd_no_bots_allowed"	"Der aktuelle Spielmodus erlaubt es nicht, Bot-Marines hinzuzufügen"
"rd_revive_marine"	"Halten, um Marine wiederzubeleben"
"rd_reviving_marine"	"Wiederbelebung..."
"rd_revived_marine"	"%s1 hat %s2 wiederbelebt."
"rd_suicide_female_revivable"	"%s1 hat sich selbst außer Gefecht gesetzt."
"rd_suicide_male_revivable"	"%s1 hat sich selbst außer Gefecht gesetzt."
"rd_team_killed_revivable"	"%s1 wurde von %s2 außer Gefecht gesetzt."
"rd_killed_revivable"	"%s1 ist arbeitsunfähig."
"rd_chat_marine_cap_reached_challenge"	"Die aktuelle Herausforderung erlaubt nicht mehr als %s1 Marines"
"rd_chat_marine_cap_reached_server"	"Dieser Server erlaubt nicht mehr als %s1 Marines"
"asw_weapon_gas_grenades"	"Gas Grenades"
"asw_weaponl_gas_grenades"	"TG-05 Gasgranaten"
"asw_wdesc_gas_grenades"	"Ein Satz hochgiftiger Gasgranaten. Setzt bei der Detonation ein biologisch gefährliches Gift frei, das einen kleinen Bereich mit einer Gaswolke bedeckt. Alles, was auch nur im Entferntesten mit diesem Bereich in Berührung kommt, verflüssigt sich und zersetzt sich mit extremer Geschwindigkeit. Der Umgang mit diesem Material erfordert die Standardbescheinigung für den Umgang mit medizinischen Biogefahren."
"asw_weapon_gas_grenades_attributes"	""
"asw_weapon_heavy_rifle"	"Schweres Gewehr"
"asw_weaponl_heavy_rifle"	"22A5 Schweres Sturmgewehr"
"asw_wdesc_heavy_rifle"	"Das 22A5 Schwere Sturmgewehr ist eine Variante des 22A3-1 Sturmgewehrs mit einem größeren Kaliber. Es wurde entwickelt, um effizienter gegen gepanzerte Ziele zu sein. Der Granatwerfer an der Unterseite des Gewehrs wurde durch einen Funktionserweiterungsmechanismus ersetzt, der bei Aktivierung die Feuerrate des Gewehrs für eine kurze Zeit erheblich erhöht."
"asw_weapon_heavy_rifle_altfire"	"Abgaben"
"asw_weapon_heavy_rifle_attributes"	""
"asw_weapon_medrifle"	"Sanitäter SMG"
"asw_weaponl_medrifle"	"IAF Sanitäter SMG"
"asw_wdesc_medrifle"	"Das IAF Sanitäter SMG ist ein Kompromiss zwischen Feuerkraft und Heilungsfunktion. Es wurde von den Interstellar Armed Forces als Kombination aus der ST60 Maschinenpistole und der IAF Mobilen Heileinheit entwickelt. Sie bietet sowohl eine hohe Feuerrate als auch eine Heilungsfunktion mit dem IAF-Regenerationsaufsatz. Es wurde entwickelt, um Verwundete unterwegs zu behandeln. Nur für ausgebildete Sanitäter mit Kampferfahrung."
"asw_weapon_medrifle_altfire"	""
"asw_weapon_medrifle_attributes"	""
"rd_afk_not_allowed"	"Auf diesem Server oder in diesem Spielmodus ist es nicht möglich, eine Pause zu machen"
"rd_flashlight_not_allowed"	"Auf diesem Server oder in diesem Spielmodus ist es nicht möglich, die Taschenlampe für Marines umzuschalten."
"rd_flashlight_toggle"	"Taschenlampe"
"asw_iafranks"	"IAF RÄNGE"
"asw_iaf_heroes_title"	"Helden der interstellaren Streitkräfte"
}
}